content	label
ابشر طال عمرك	Other
وش للتبديل الغبي ذا؟؟؟؟؟؟	Other
فيه فلم مدري مسلسل نزل ل زياد العمري لي اسبوعين ادور عليه اتوقع اسمه ( جُرذ ) كيف اشوفه او بس يعرض على صالات السينما؟	Other
يعني الجبال الباقيه على الارض مديلها جديد ولا خلقت الا بعد ذا الاحفوره !!!	Other
قويه قدام الغياب مايهزمني بُعد مخلوق مثل م حبيتك اقدر اكرهك .	Other
لاماله علاقه السجل تواصلي مع شركة اللي كنتي فيها هي سبب الرفض	Other
الله لا يحرمني منها يارب	Other
USER العيون تحكم ياما نخدعنابالنظاره	Other
اذا ندمت اني كلمت شخص احذف المحادثه وبكذا احس اني ماسويت شي.	Hijazi
USER مبروك وعقبال الدوري يارب	Other
USER وجععع شررر شرررررررر	Other
خساره ما لحقت قبل العشر دقايق	Other
ماقول غير ياحظ الي بيشوفك بالعيد بالوردي حياتهم بتصير زي لون الفستان العيد حقه بيصير لونه وردي	Other
USER لما اقول لكم علموني السواقه URL …	Other
الاختبارات جت والضغوط جت ولا يحتاج اقول النفسيه وش بتصير	Other
مساء النور يالسهلاوي	Hijazi
انا حامل فشهر ثالث وفصيلتى سالبة متى اخذ الابرة حقت الفصيلة	Hijazi
كُنت روحي .. لمّا كان جوّايا روح.	Hijazi
USER يابتاع المخدات انت هههههههه	Other
USER USER إنسان مريض يريد الشهره على حساب النصر ...وبالنسبه للاعب خذناه غصب عنك وعن ناديك ....دق خشوم	Other
مابي من هالدنيا الا انت #صفوان_عشقي	Hijazi
اجي وعندي عزبه القهوه والشاهي والطبخ	Other
صباَح الـ: ياكثرك في باليّ ويابُعدك عن عيونِي.	Other
ترى ناقص الشباب ٤ لاعبين اساسيين بالاضافه الى الحظ كورتين بالقايم وبلنتي ضاع	Other
طلعتي من دوامك ؟	Other
USER في مفاجأة لك بكرة	Other
مايحتاج مجيد ماشاء الله منجد برز نفسه وبقوه URL …	Other
حريم انسجنوا (25) سنة مع بعض أول ما طلعوا من السجن وقفوا عند باب السجن ساعتين يسولفون	Other
اجلد هم جلد	Other
شوفلي تذكره تكفى تكفى تكفى	Hijazi
- ابسط انواع العذاب غرفة ما يوصلها النت ›	Other
ياخي اغبياء مرا	Hijazi
مشكله السنقل لما يصور صور حلوه ومايدري يوريها مين...	Other
متزاعلين عشان درجه	Other
المقطع ذا فعلا قديم؟	Other
الصراحه مشكله تكون صاحي لهالوقت وتفكر ولحالك	Other
مشيت كثير وسيارتي بعيده بديت اخاف	Other
وين باقي الشيعه تعرف انه الحق للتسنن والتشيع عذاب وتلاعب	Other
﮼هههههههههههههههههههههههههههه تذكرني بالنظام القديم	Other
"- إحفظ بنات الناس تستر خواتك ، ومن دق باب الخلق مدقوق بابه ! \""	Other
ياشين التكبر والغرور	Other
ممتاز احتاجها ماالقى نسخة مجانية في سورس معين	Other
USER كلام سليم يا شيخنا بدال التصوير وعض والتميلح URL	Other
"\" USER : شوفة الأحباب صارت صعبه صعبه .\""	Other
#جملة_مافي_أم_ما_قالتها أربع وعشرين ساعة على هلجوال	Other
مره ثانيه ان شاءالله #تصريفه_دايم_تقولها	Other
والله لعيب بس ما اخذ فرصته	Other
مبروك وجدان تستاهلي اكثر شاهدين لك يارب	Hijazi
انا والله مو موّنسني في حياتي الا نوره ,فعاليات اليوم لاتقدر بثمن	Hijazi
يحطط الملك سلمان عذر الزلابه يعنني وطني	Hijazi
" USER وانت من آهله ومبرووك الدوري ابوفيصل \""	Other
ارحب يالامير بعض مالديكم ربي يسعدك	Other
الله يسلمك وياك يارب	Other
الله يبارك فيك سلوم	Hijazi
شكله عبدالعزيز العجيل	Other
الله ياخذك يابيب واضحه وصراحه اللقب لذولاك	Other
وزير الصحه يحضر حفل تخرج الالاف الاطباء والصيادله والاخصائين الصحيين ويقول ثروة الوطن ولكن مادرى انهم بينضمون لاخوتهم العاطلين	Other
اذكر مقطع الجمال في المطر قبل فترة وكيف اثر في الناس كلها هنا وحتى الغرب شفت كم برنامج يتكلم عن المقطع بكل دهشة وجمال، ومن جانب ثاني اشوف أفلامنا وبكل صراحة تخاطب الغرب للأسف وهذه هي المشكلة لأن لو حاولو مليون مرة لن يصلوا لهم وبالتأكيد لن يصلوا لنا.	Hijazi
وين شرق والأسعار اذا ممكن	Hijazi
#Ramon_Díaz_vamos_te_amamos انتا معلوم كويس انتا كويس	Other
لاتنشد عن الحال عقب ماقفلوا الدفعه الثالثه	Other
انا ليش للحين صاحي؟	Other
بعذرك ع الرد البارد،واعذرني اذا تغيرت..	Other
USER صح السانك يامبدع	Other
اسعد الله أوقاتكم الي يبي رتويت يرسل تغريداته للحساب وانشالله نستفيد ومفيدكم	Other
جعل ماقدم في ميزان حسناته ويستاهل الخير ابو محمد	Other
صحيح عوض لاعب مهم ، لاكن النصر عمره م يوقف على اي لاعب مهما كان أسمه . النصر اولا واخيرا والنصر دائما وابدا #عوض_خميس_هلالي	Other
الدون سبب الخساره ي نواف ولا كيف!!	Other
احبك ايه احبك بالعزّ الشريف قريب ولا بعيد على عهدي احبك	Other
صادقه والمفروض للزوجد حدود عن الرجاجيل الكفو	Other
USER احب الخصوصية ، لكن للاسف كل اخوياي يعرفون الرقم السري يعني بس منظر جمالي لا أكثر	Other
هههه جيت براجع اكتشفت اني قاعده اذاكر من جديد	Other
لو ابي غيرك ترى حولي كثير بس قلبي ما يفز لكل عابر!	Other
USER عندك علم من ذَا في الحصين URL	Other
الله يسعدك قد ماضحكتني	Other
ﺎلحيااةة ‏ﺎلتي ‏ﺎعيشها ف مخي م يعيشهاا رئيس دولهہ ̶̶̶	Other
اجل ادعي لي	Other
عاد مشكلتك احذفي التغريدة	Other
وين العمليه الفدائيه الله يهديك راحو للموت بكل برود	Hijazi
فيه اشياء لو يحسنها كمارا بيكون واحد من اخطر الاعبين السنوات القادمه . هو يملك البنيه + السرعه . مشكلته تكمن في عقليته مايعرف متى يمرر وولا متى يشوت مايعرف وين يتمركز لاعب خطير بدون كوره خصوصاً فالضغط وسيئ بالكوره . الخلاصه كمارا قابل للتطور اذا اعطى الكوره حقها لانه صغير جداً URL	Other
انتو نسيتوني ولا ايه URL …	Other
ناقصين كلام حنا نبي فعل فعللل	Other
انا شفت نشره من الوزاره محددين سن معين وهو ٤٠ سنه مايعطون ايفاد للمعلمه ماادري صحيح او لا	Other
وليت الشعور اللي فيني يوصلك بدون كلام.	Other
يارب يموت يوم السبت	Other
USER الحمدلله ظهر العنصري من جد ، ولا لو بتعرف مين مصخرة فريقك والله :)	Hijazi
ههههههههههههههههههههههههههههههههههههههههههههههههههههههههههههههههههههههههههههههههههههههههههههههههههههههههههههههههههههههههههههههههههه والله من كلمه مكطوف غسلت يدي	Other
الناس اللي ابتسامتهم تسبق سلامهم الله يجعلكم دايم بطريقي.	Other
نام الوجود من حواليا	Other
وانا كمان يارب	Other
ممكن تجيني خاص	Other
لأجل عينك تنعمي مليون عين انا فيني عن هوى غيرك عمى!	Other
لا مت حب قلبك هم تموت المشاعر ولا صحى قلبك. يفز لك قلبي من مكانه نفس الاحساس واللي يحسبها الشاعر حس الشياطين تركبه لو نواء يغيرمكانه URL	Hijazi
حلوه بس لا تعيديها	Other
USER ههههههففففف جو فكك	Other
رحت دي جي اصيل وأخذت ساعه ونص بالطريق وآخر شي طلع العدد مكتمل	Other
لازم يسوو وزارة للنضافة وينزلو قرار استخدام مزيل العرق اجباري	Hijazi
#من_نسق_سامي_الجابر_من_الهلال صدقه جاريه لأخي يوسف الشعفي اتمنى من كل شخص شاف الفديو هاذا يسوي اعاده التغريده URL	Other
أنا يادوب متحمله ثيابي حالياً	Other
لا تموت علينا انت ماعندك غير سالفة الدخان	Other
انا انسان عندي كرامہ اطلب الشيء مرة وحدة ما تعطيني اسرقہ ☻~o)'	Other
القلوب والاكباد قدني بقلب الزير الليله	Other
Hazard recognition &control أحسن شي تجي متأخر والترينر مابعد يجي تباً له (at Saudi Aramco) — URL	Other
طيب ايش دخل الوزارة هذي وفاه طبيعيه	Other
اتوقع راح تضيع	Other
دفعه نامت ودفعه صحت وانا مع الدفعتين مستلمه	Other
ماشاءالله عليك ينقط الذكاء منك	Other
USER @: صباح الاماني المشرقة صباح الأزهار المتفتحة صباح الطيور المغردة صباح رقص الاغصان صباح حب الاوطان احلى صباح لك انت وانت وبس	Other
#NAME?	Other
USER USER USER USER USER USER لا هنت ابو نواف	Other
ايه كثير قالولي نفس كلامك عشان كذا ماتحمست ، اففف عندي تقشف مسلسلات امريكيه	Other
أنا أحاول بهالمساء أكون أنسانة أفضل مما كنت عليه بالأمس واليوم ولنفسي مو لحد .	Other
ترى ودي اقضّي العمر يا عمري معاك	Other
قد تيا صباحي ومساي هههههههههههههههههههههههههههههههههههههههههه USER .twitter.com/LUeQ3HN314	Other
طيب كريس ٢٠١٣ ولا بطوله وحقق البالون دور	Other
الله يعطيك العافية	Hijazi
وافي وسعدني اتصالك ولله يسلمك من كل مكروه	Other
هاردلك كليبرز ، القادم أجمل	Other
يفوزون بأخس فعالية باليوم الوطني اللي مسوين تحدي النشيد الوطني	Other
الله لا يهينك يابو ياسر. وما عليك زود يالخال.	Other
لا عااد الا السالفه ذي ماتاصل كذا ياوحوش	Other
"لما يصير لك موقف يخليك مستانس طول اليوم .\""	Other
راحتي أشوفها بين عُيونك بوسط ضحكتك بِعز عافيتك أنا راحتي مرتبطه فيكَ.	Other
".. كنت بـ عيوني تساوي كل غالي و كان يكفيني من الدنيا .. وصالك ابتعدت و جاي تسأل كيف حالي؟ ما تبدّد شرهتي بك ‘كيف حالك؟ \""	Other
دواااااام و الدوااام لله ( USER كافيه | Barn Caffe) URL	Hijazi
المنحوتات الأفريقية كذا	Hijazi
ركزووووووو في التخصص من جد لازم يكون عشواااائي URL	Hijazi
بيطق فيني عرق اذا استمرينا كذا لا اله الا الله .	Other
لازم نفوق و الا هنشيل زلط في الماتش ده	Other
احلى خبر جاني في ٢٠١٩	Hijazi
انا تعبانه عشان بشرتي تعبانه	Other
اي الفروع في ابها بكره مابشتري الا منكم	Other
مو بس شعري يتساقط،لا حتى رموشي صارت تتساقط.	Other
بالله كيف الدوري الالماني يصنف من الخمسة الافضل URL …	Hijazi
اعشقك واللي خلقني . URL	Other
ابوي الله يطول ف عمرك URL	Other
يعني مب حالة لي كل يوم اصحي هالحزه جوعان ):	Other
USER شد حيلك وخلينا نشوف شغلك وانتاجيتك بالعمل والارتقاء بصحه المريض متفائل فيك	Other
هالعمر يبغى العاب تشغله .. اشتري لها كم لعبه وطلعي لها كل اسبوع لعبه عشان تنبسط. وانتي كل ماجيتي تهاوشينها تذكري انه بيأثر على شخصيتها ١٠٠ بالميه وبعضهم يسبب لهم تاخر بالكلام ف انتبهي انتي مُحاسبه بس هي طفله ماتعي شي	Other
ي كرهك نغيله صدق	Other
السلام عليكم انا اختباري قدرات ١١ رمضان ابا تجميع محوسب كويس.	Other
مشتـاق وأخاف لو عبّرت عن شوقي - تشوف نفـسك عـليْ وما تعـبّرنـي . #متعب	Hijazi
USER ماعرفتك يالاطخم طالع اطخم ولك	Other
شكرا اسامه حبيبنا يا أس..	Other
متجهزه للخساره اشوف وين ثقة الزعماء بطلي خلاص مايصلح	Hijazi
طيب والحاجات الزادت دي البرجعها شنو؟	Other
مرت ١٣ دقيقه م صارت كتابه	Other
لك أنا ، لك عيوُني والعمر.	Other
مستحيل توصل الصواريخ المذكورة لـ هالمسافة	Other
USER عندي لك سوال ال مره من يرجعوله في يام ومن اقرب فخذ لهم يالعريف اذا انت مري	Other
ليه غايب والسوالف تحتريّك .. قهوتي والشُوق واشعاري وانا #نجران_الان URL	Other
قلت ما مثلك على الدنيا وصيف لا حشى مالك وصوف ! #محمد_عبده	Other
لو تكرمت اخوي هل هو بيفتح في الوقت الراهن ؟	Other
دعم #الداعم كان خفي؟ من كثر ماهو خفي ماهو موجود اساساً ! كحيلان ووالده هم الداعم الاول للنصر #الكاش_انحاش #فيصل_بن_تركي #فهد_المطوع #النصر	Other
السلام هذا السحب لمسابقه العوده للمدارس او المسابقه حقت نهاية اكتوبر	Other
يرزقنا الله بناكل فصفص	Other
احب انك تعرف كل الأشياء اللي ماترضيني ومستمر فيها	Other
انا: ببدا اذاكر مخي: نبي ليتات ف حديقة صباح السالم ترا انا راسي بينفجر بكرا العرس بكرا العرس مهبل تتهاوشون على الرزق الرزق يجي من الله كلن نصيبه على الله	Other
طرطشلي خليك مؤدب مع ابناء البلد عشان ما يتم تسفيرك	Hijazi
حنا اتفقنا في كل شي الا الزمن عيى الزمن لا نتفق.	Other
والله جد طرشة	Other
وتبوك يا معالي المستشار مالها اي نصيب من الحفلات!! ؟؟؟؟	Other
انا طول عمري مخي مو مضبوط بس عاد حتى هارو ؟ ياجماعه فجأه صار يقول عوو انا مربيه قطو ولا كلب	Other
ليش اذا استحيت اسوي اشياء غبيه	Other
USER USER ليه حظرني ماعمري سويت له منشن !!!	Hijazi
#النصر_الهلال يارب يجي حارس الهلال صداع ويعطينا هدية	Other
بتتّعوض كُل حاجه، والعُوض من ربـِي حُلو.	Other
الله يسعدك .. فديتك	Other
منجد والله. ومتأكد ان فك الارتباط حيكون خير لنا ولهم	Hijazi
الوصفة عبارة عن بهارات وشوية إندومي	Hijazi
بيض الله وجهك يا تركي وكثر الله من أمثالك على ردك على سماسرة وبياعي الأرض الفلسطينية .. URL	Other
كل سنه وانت طيب ايزي	Other
كاني اشوفك تترجي يفتحون لكم سلوى ياحميده لكن سلوى ماكو	Other
لا تتأسف كنت ماضي والحين نسيتك	Other
USER خخخخ جايزتلك الفنتووو واااجد	Other
نعمممم كيف كدا من فين أتنيلتي ونسختيها	Hijazi
شكله هي الي توجه ازواجها ماهي معقولة كلهم مجرمين وهي تتفرج ..!	Other
تجحفلنا و اجلوه بكره	Other
صح لسانك والله يابو محمد عز الله إنك ابدعت وامتعت يالجزل USER	Other
مساء الفل يا برنس	Other
ان كان صدر اللي احبه وسعني ما همني ضيق الزمن واتساعه :	Other
صح مايلعب زين	Other
تسلم يمينك على هاللقطه الجميلة	Other
اييه بريك ما تدري وش تسوي فيه .. فراغ غريب	Other
يسلم راسك الكل فاهم عليك و نعرف نوعية جمهور النصر بكائيات ف كل مكان	Other
اتوقع لصيده تصيبها نفسيه من كثرهم	Hijazi
#مواليد_اغسطس كل اللي بالهاشتاق مزايين الا انا اشهب الهب ليه ؟ قدروا اننا عيال شهر واحد	Other
ههههههههههههههههههههههههههههههههههههههههههههههههههههههههههههههههههههههههههه الله يبعدنا عن فتن الدنيا	Other
شكله مطول دائما الاهلي يتاخر.	Other
الحجاب شي شخصي مالكم اي دخل فيه. #نصائح_لرجال_الهيئة	Hijazi
كنت منتظر دا الموسم يبدأ بسرعة لكن ياليتني م انتظرت #ليفربول_بيرنلي	Hijazi
برا يابن الكلب!!!	Other
شايلين لينا قروش ورق ساي	Other
لمن يأذن فجر وباقي لي نص المنهج URL …	Hijazi
USER السلام عليكم ورحمة الله وبركاته.. اليوم نزلت مقطع عن فيفا١٤ طبعآ URL لايك+اشتراك+مفضلة #رتويت	Other
"بنت خالتي -٥ سنوات- تقول لأهلها \"أنا ايش سويت ذنب في حياتي عشان تسيرون إنتو عائلتي؟\""	Hijazi
USER إذا مهتم تشوف ؟ مصور فيديوات كتير	Other
كيف يكون تشهير اذا اسم الطالب مو ظاهر	Hijazi
﮼غير،قربك،مـا،اضن،عندي،امانَني،ثانيه . URL	Other
لمن انسا نضارتي في البيت بالله كيف عيوني حتتحمل الشمس	Hijazi
لاحووول وش فيهم العالم سرقة وخطف الله لايسلط علينا	Hijazi
#المعجبيه_تنخى_اهلها تكفون يالمعجبه تكفون ياعيال العون لاتخلونها منكم وفيكم تنخاكم لوجه الله	Other
لو خلوني مذيع معها صار ثنائي جميل للغايه يارب يعطون سداح فرصة عندي مواهب الحمدلله ما تجيب العيد من وراها التزكية انتضرها من الدكتورة ناديةالتميمي ما أخلى من توصياتك USER	Other
ارقد تطمن تراك بدنيتي ( غالي ) خل الهواجيس عنك واعتمد بالله	Other
اشتقت اكتر والله .	Hijazi
نفسي ارتوت هنا بس اخاف ابلع تبن URL …	Other
مريض الضغط لو قولتله امنع الملح هيعمل كده؟!هرمون برضوا و لا اراده ؟؟	Other
لاه لاه الا خطوة جنوبية لاااا ، اهل الجنوب انا اقدم لكم اسفي واعتذاري	Hijazi
الله يسعد اوقاتك أنا وانت عارفين من وضع التاق هم سمعوا ان اللاعب أوعز لناديه بالإعتذار؟؟	Other
الي عندهم حسابات مفسرين احلام يعطوني حساباتهم وشكراً	Other
الصورة هي كل مابشوفها بحس حالي نعست URL …	Hijazi
حسبنا الله عليك يامعضل كان ماتشوف حل للسباك الي يا العب بطاني يا اخرب عليكم غيروه ماهو لازم سييرا	Hijazi
USER هاي اخوي ممكن خاص	Other
يقهرني الي يكتب عن الكذب وهو يكذب ..	Hijazi
اعطيك ليش ما اعطيك تعالي وابشري	Other
بدري الكلام عن الصدارة يا ناس	Hijazi
شوي شوي على فواز ترا كذا كثيييييير	Other
والله حلو مدري فيكم	Other
هههههههه اشبك عصبت ياخي انا رشيق بس انت عيونك عيون جمل تشوف الحاجات كبيره	Other
وربي انك خاينه صدق	Other
جوال سماعه عصير بطاطس	Hijazi
#NAME?	Other
اليوم أول يوم دوام ف المركز ، يا رب يوم خفيف لطيف نصنع فيه الذكرى الحلوة .	Other
USER احرميهم منك العشا الجاي شوفي الموضوع الجاي على مين بيكون من باب العداله لكل،صدقيني بيفقدونك	Other
تسلم الله يعطيك الله العافية	Hijazi
USER يقصدون المريسل مسوي وطني	Other
؟؟؟ من جدك بالله	Other
الحمدالله على سلامتك و ما تشوف شر USER	Other
التمر الكل بالكل ياست نور	Other
يصير تبكين بحضني ؟	Other
شدي حيلك وجمعي حقه.	Other
من بينهم كلهم ترا فرحتِي معك	Other
يارب انك تشفي كل واحد بعقله جزمات .	Other
اكثر شخص كان يستاهل يكون موجود بهالبطولة لكن هذا اللي خذيناه من المنتخب للاسف	Hijazi
عسآني فدآ مآطآ تعبهآ وَ هي ترتآح ، جعلني مآ ذوق آفرآق ذآ الصوت وَ النبره .	Other
ياللـه لمإ تلاقي شخص يشبهك بحكيك بتفكيرك وحتى الاشياء اللي تحبها تحس ودك تدخله جواتـك وتقوله انإ وياك “ادمي واحـد“. *	Hijazi
مفارش نفرين ٦ قطع حشوه وسط من بره فرو ناعم ومن الداخل مخمل لحاف ٢٢٠*٢٤٠ شرشف مغاط ٢٠٠*٢٠٠ 2 كيس مخده ٥٠*٧٥ 2 كيس خداديه ٤٥*٤٥ السعر 240ريال W012_ماى_تارقت# URL	Other
يا رب نمشي خفيفين ظّل ، راضين مُرضين ، ما لأحد عندنا حاجه ولا منا في قلب أحد أذى.	Other
يانفس لامتي :على مزارق الطيب وش عااد متي صه : ثم إسمعيني إن كان لي جبتي حصيل ومكاسيب ابي نتايج طاعتي لك / عطيني؟ #سعد	Other
الاماكن اللي مريت انت فيها عايشه بروحي وأبيها .	Other
اذا جاتك افعى بتأكلينها وتمسحين على راسها ؟	Hijazi
صارلهم سنتين حاذفينه وينك فيه انت	Other
هذا يدل انه الشركه الي انتي فيها الحين . م عندهم عقابات صارمه اتجاه الموظف . او حتى م عندهم احترام للعميل و هالشىء يضر ب الشركه كثير .	Hijazi
محامي جيد .. ودوني المحكمة حاالا URL … URL	Other
مو الله يبارك فيك	Other
USER . بالعافية عليك بوفاهد	Hijazi
ياربي لك الحمد اجل ، كله خرطي اجل	Other
هههههههههههههههههههههههههههههه من جد يتوب علينا ربنا	Other
شيلو معاه ملاذ بشيل 24	Other
USER الله يباركك فيكك	Other
لمن السيزون 3 كان مرة خطير والان سار زي الزفت ماشاءالله وكلو مطمطة URL …	Hijazi
عطوني علاجي لو انه عنزروت ماهوب مرّ ! المرّ جربت طعمـه ثنتين .. ورنّي مماتي قبل اموت يوم الفراق ، وحاجةً عنـد رخمه !”	Other
أنا ماعندي معجب سري عندي نفاق سري عاهات سرية خبث سري.	Other
اصير مدير اعمالك	Other
بببببطططني يعورني والسسب اتوقع اني جوعانه واكلت شبسات وهذا اكبر غلط  	Other
ارضي يا زوري	Other
يا ماخذ الحب قل فيني و سمعني،، حب على كبر صعب أبدل بغيره!! #حسين_عبدالغني #النصر URL	Other
#NAME?	Other
يجيك يقولك الحين ( الاولويه صعبه قويه ) URL …	Other
USER USER قلتلي في اي مجموعة في اسيا ؟	Hijazi
USER لاتمسحينها خل نجلدهم	Other
خليك في عِشك ماحد يِنشك	Hijazi
شباب يتحدون واحد يحط السكين في مكينة تسخين التوست وهي مشبوكه بالكهرباء ̷ ! ا URL	Other
اتمنى اني اواسي صديقي لاكن انا جد ما اعرف	Hijazi
تذكرون الحلق الجميل شفت كثير يسألون من وين وبعد البحث حصلت لكم موقعهم الرسمي ويشحن مباشر .. URL	Other
ييييالللليلللل حنا وهالنننشببببه	Other
بعد منتصف الليل وخذلك فصفص مصري عشان السهره تحلى ودبه ماء صحه صغير للبردقان	Other
اللي بالصف الاول اخر واحد يمين	Other
USER نجحت وااه يابختك انا حاولت مانفع	Other
روووووح الواحه يسحب ٤٦.٨٥	Other
الله كريم سبحانه هذا احنا ندور والامل بالله على فكره انا كنت موظفه قبل شهرين راتبي٧ونص وطلعتني بعذر((انا عرفت ع كل شي بسرعه))	Other
تابعن اتابعك تلغي الغي سالفة انا الهامور يتابعوني ولا اتابع مي بعند... - عزالله انك صادتز URL	Other
ههههههههههههههههههههههههههه وراه انصدم اخر شيء	Other
الله يجزاك خير هذا يدل على معدنك ذهب. ماهو نحاس الي مابه خير وش يبغى فيه.	Other
تلقى بني عمي اكعام للحريب = لارزت الرايات والنشر الخضر خوالد ترد المعارك ماتهيب = وردوا حياض الموت يوم الله ومر”	Other
استغفرالله العظيم مع وقت الصلاة جاني النوم انيهوووووو الشيطان	Hijazi
مخالفه مروريه !! خله وش دخلك فيه ياخي سكتوا دهرا ونطقوا كفرا هههههه URL	Other
ونجمه تضوي بسمتك لو هي بعيد .	Other
بلحظة كل شي ممكن يصير صحيح للأسف'	Other
USER عشان نكون واقعيين , مباراة النصر مع الإتحاد وتخبصات دونيس هي من جعلتنا أن لا نتفائل ,, الله يوفق زعيمنا الليلة	Other
كمية مرض و تخلف الى ايييننن؟؟	Other
يسوي زي الخواجات	Hijazi
هذا جنس ثالث الدون دايم مغتصبهم	Other
وححححححش وربي وحششش USER	Other
USER حكمه الله صعب فهمها .. تشوف الظالم يعيش ويفرح في دنياه .. لكن في لحظه يتلاشى بعظمه الخالق	Hijazi
والله سواليفكً كلها اللغاز	Other
الصبح عندي مرتبط مع كيونغ سو ، خلوا عنكم فيروز	Other
ماهو بكيفك تواصلني وتقطعني أما غلا بينن أو فضـها سيـــره	Other
لمن اتضايق بمكان عام والكل يستغرب بهاللحظه ينسون انك بشر ولك مشاعر والمطلوب انك تجامل بهلشي ويجي احد يطبطب عليك ويقولك لاتبين كيف ماابين وكل شي واضح بوجهي ونبره صوتي	Other
افضل تكتيك دفاعي ممكن تشوفه تكتيك ايرلندا الشماليه ضد هولندا الشوط الاول	Other
بعرس كل سنه باربع انتي الاوله	Other
ايه ومنهم انا مو يقل احذفه مره وحده URL …	Other
"انا .. وياك ما يكفيني حب الأرض احسّ اني بـ احبك حتى \" بالجنّه \" ؛)"	Other
رايح بيشه قاف مجنون SoSo URL	Other
هلا هلا هلللا URL …	Other
#تويتر الجوء يقول فيه مطر ان شاء الله #جبال_فيفاء_الآن URL	Other
USER لا مهي صعبة بس مشكلة	Other
اذا لقيت حل علمني نفس حالتك انا	Other
بدر يقول كيسه مرامي وتخب عليك اهم شي احد معبرني	Other
هو شي متوقع بس اعجبتني الحركة	Other
أحسن الله عزاك يابونواف ويعلم الله اني بعيد عن تويتر ولا دريت الا اللحين وب اذن الله بتصل فيك ان شاء الله اخر الاحزان	Other
عمري مابالغت بمشاعري أنا فعلاً أحبك.	Other
اتأمل صُورته واقول؟ وخَالق هالعُيون مَ ينمحِي حُبه أبد.	Other
"جوات البي ، حكي مابينحكي.. مو مشان شي\" بس كرمال ماوجع حدا معي `~"	Hijazi
USER أشوى إنها كانت تقصد السماعات	Other
وفرها بجيبك وين وجهك وجهك قابل لتامل اكثر من الغيوم URL …	Other
ولو أخفيت شوقي عنك ، يفز القلب لك من دون طوعي	Other
#مستمرين_ومقاطعين_المراعي انا معكم في المقاطعه من اول يوم وان شاء الله مستمرين الي مالا نهايه والصافي ايش زينه .	Other
خزعبلات الحين اترك التعصب على جنب وناظر بفريق التعاون وبفريق الاتحاد تحس الاتحاد ضعيف جدا مستحيل يفوز واتوقعها تاريخية قدام الملك وجهت نظر فنية	Hijazi
#كيف_تعرف_انك_دلخ لما اشوف ٣ خيارات كيك في وجهي	Other
كنتي في جهدش ثم خربتيها بالتعليق التالي ذيا	Other
USER USER فنقر نافس فرقسون واخذ منه دواري وبطولات .. ناديك غير 99 مدرب وعجز ينافسه	Other
لاتحتكي بحبيبي لا تحتككككي لو سمحتي ميو	Hijazi
USER ع ذوقك الجميل (:	Other
اول م شفتها حسبتها بسكوت اوريو	Hijazi
USER يسعد مساك ممكن اعرف اخر اصدار يمكن يركب عليه الجلبريك	Other
انا كل شي أبي اسويه بكره ، بس ما أدري أي بكره	Other
اي بس عادي تقدر انك ما تلعبهم جميع	Other
ذي اخسسسس نومه في حياتي كلها أساس مستحيل تكون نومه أنا انام شوي فجاءه اقوم ماسوي اَي شي لي الحين نص ساعه قايمه ماسويت اَي شي بس جالس كذا ):	Other
وبعدين مع الناس الي تبا تمشي الناس على مزاجها	Hijazi
لصار ما ودك وخاطرك طايب أنا ترى لي خاطرٍ منك ما يطيب حتى ولو إنك عن العين غايب متسيدٍ لاشك خلف الـمحاديب	Other
حي نباك ونباه ياسالم	Other
عمومًا كلمه -يلا ما عليه - هي اكثر شيء تخليني اغير فكرتي للشيء و ارجع شخص طبيعيه و يصير الشيء أساسًا مو هامني بكل سهوله ..	Other
يوم إن جدك وتق القفل بالدار= بيت الشعر مفتوح صبح وعشية. للضيف ريف للمعادين جبار = نرد العياض ولانهاب المنية. #ايه ي بعد حيي وميتي	Other
لاعب السيلتا واس والله ي هو لعيب لكن مامعه احد	Other
عز الله عدمتي مستقبله	Hijazi
USER علموني من الفنانة العالمية لا تخلوني لاني مقيد ولا مفكوك بيني وبينكم ماحد بداري	Other
صح لسانش هو صادق	Other
تعال وحط ايدك على قلب مغليك وتسمع لنبضات قلبن يحبك . في ذمتي انه من اقصاه هاويك وانه يعيش اجمل غرام بقربك... #الرايد_النصر URL	Other
الي شراء حلواني 74 يبع الان 75	Other
اخ يالضحك هههههههههههههههههههههههههههههههههههههههههههههههههههه هههههههههههههههههههههههههههههههههههههههههههههههههههه هههههههههههههههههههههههههههههههههههههههههههههههههههه هههههههههههههههههههههههههههههههههههههههههههههههههههه هههههههههههههههههههههههههههههههههههههههههههههههههههه URL … URL	Other
زححححمة و فيه اماكن مخصصه للاحتفال ما قالو احتفلو فالشارع	Other
عن نفسي انام 12 واصحى 5 ونص اودي اخواني دواماتهم وارجع اشوفها 6	Other
عرق الارمي القوي فيني شوي ويطق	Other
احبببك دايماً تقولي الي ابغا اقوله	Other
ولما يعود من المشوار ، كوني الزِينة ع بوابو .	Other
انا م عندي لهجه محدده ؟ اي كلمه تعجبني اخذها .	Other
USER خلإص إوك بس إذا رحت ورئ الشمس حاولي انك تجيبيني **	Other
اقول اتركِ عنهم وداومي	Other
USER شفتي شلون . إكشخ إكشخ	Other
يارب زين وثلج وسلاح جديد URL …	Other
ربي يخليها ويزيدها من فضله	Other
هههههههههههههههههههههههههههههههههههههههههههههههههههههههههههه واضح يحبها الزواج قريب	Other
يارب قد ما غلبني الشوق لجدي و قد ما تمنيت اشوفه اغفر له ، يارب قد ماجت صورته فبالي اغفر له ، يارب قد ماتمنيت اسمع صوته اغفر له	Other
صح أنا أميرا	Other
لا داعي للإعتذار ، اتوقع ان اجابتي صحيحه بنسبه 90٪ وعارف قصدك من السؤال مسبقا	Other
ناه من جد اعني دا الشي... اعتقد عندي نزيف في راسي مدري مخي و مسخن و ما نمت كويس من امس ومدري كل شي	Hijazi
لا تتفائل واجد ، اتمنى تقلع الرحلة في وقتها فقط ولاحقين على المواصفات العالية والاجهزة الملاحية والإضاءة ، إبدأ بضبط جودة عامل الوقت (إقلاع وهبوط) بعدها كل شي بيضبط	Other
اش دخل ال دليم؟ ؟	Other
اخيراً نقعد ساعه مانقدرنا ندخل الدوار	Other
الف الف شكر لحساب الاداره لدعمكم لنا يعطيكم الف عافيه	Other
"أكبر بخيل آلي يمانع بالوصل .. يوم آلهواتف خلت المبعد : قريب !\""	Other
شجاع ، كريم ، زعيم ، ماتخاف ، لو تسثرت علينا حشوده ، ذيب طليب تخلي الذيب ينهار، اسد تخوف جميع الأسوده، فتين ، متين ، بطل ، بطار ، راس الجبل بالحرب خرقة سنودة ، حر، مر، للعدو سطّار . USER #حمدالله #الوحده_النصر URL	Other
الخد لمحه كنه النور وهاج والعنق يشبه للمها والغزالي شفة حبيبي كنها الجمر وسراج ورموشها ياناس تقتل رجالي	Other
وحشه شوفتك اكثر كل ليله مع طيفك حبيب الروح انا اتحسر طاير من عيوني النوم على هذا الحال انا كل يوم سمعني حبيبي الصوت وسيرني على كيفك URL …	Other
شوفوا عبادي كيف قلب العود الى قيتار URL …	Other
#نجران_الان #الافواج القبيلي متى يقاتل بذمه وضمير. في( ارض وعرض ) وتصبح حرب قبليه بأقل الخسائر من الطرف الثالث . استراتيجية فرق تسد . طبعا ذا بس النتيجه الأوليه من أفواج #نجران.	Other
عمكم العالمي قربت قربت	Other
أنت لا اقبلت طارت هالحروف .. وامتلت سدرة أنفاسي رفيف .. في الحنايا مثل ضرب الدفوف .. عرضة الحرب في اليوم المخيف ..!	Other
ياشبيه صويحبي حسبي عليك URL	Other
فالمدرسة اذا تأخرت يخليني اعملها ... كرهوني فيها وانا صغير URL …	Hijazi
كثر الموت بالفترة الاخيرة وهالشعور يخوف حيل .. اللهم احسن خاتمتنا ):	Other
وش اسم المسابقه في اليوتيوب	Other
يارب الي اقراه كذب	Other
مالها دخل والله لو انها زينه كان بنقول معليه غيره	Other
مقادير .. المصري هذا تبعك؟ والا اشد عليه	Other
المفروض يحطونه بمتحف #جدعية ياابو تركي	Other
روبيرتو حرام فيك تمريره زي كذا يا زق	Other
الشهري فيه من ستايل ياسر ؟	Other
USER بنجيبها بإذن الله	Hijazi
يارب شخص يخاف على قلبي من النسمة.	Hijazi
تكفى يا نصر ترا والله ماعاد فيني حيل	Other
قربك فرح ومؤاصلك يشرح البال وحسك غناه ۈشوف زولك طماعه #هيماويات	Other
USER واحد مستلمكم بجده ووحده بالرياض	Hijazi
#NAME?	Other
USER ي قلبووس انا يخخسون محد يضايقس عططيهم ططاف	Other
يعني لما مابقي شي ع المباراه انعس كذا خيرر	Hijazi
الله ذكريات اللعبه ذي منزمان عنها .	Other
النوم ليه ينكد عليا وقت الأختبارات	Hijazi
خلاص مالكم داعي طقطقه على البنت والله جد	Other
خفت عليك من الوجع وانت اللي أوجعتني.	Other
كان يومي حلو لين شفتهم ...	Other
منور يا بو فيصل .. الحمد لله	Hijazi
من حقوق صديقك عليك انك تتحمل صوته إذا انطرب.	Hijazi
وش السالفة لا يكون معاليه هاب هبة جديدة #خذ_قسطك_من_الراجحي	Other
اذا شفت خصمك يحتفل قدامك بمنجزات غيره اعرف انه وصل الى مرحله من الذل مالله به عليم	Hijazi
سكوتي يَ صآحبي مايعني إني رآضي لآ بالله الا تجمعت من كل حدب وكل صوب	Hijazi
كفو ينطح كفو ياكحيلان اسم على مسمى.	Other
اخس ياجمهورأوضحت لك او تبي اوضح لك اكثر URL	Other
الففف مبروككك ياقلبيي الله يوفقك يارب.	Other
اقسم بالله يا اني قاعد اسوي كومباك بالفوت	Other
لالا قصدك القمريه .. هوا قال في الضلام يعني في الليل بس	Hijazi
مع إنك بتضلك ساكت، قلبي عمّ يسمعك .	Other
دجانيني ياقلبي جيب نادي يدفع شرطك الجزائي وانقلع بلا محن زايد	Hijazi
مافي صباح ولا في خير الا بعد الاختبار و شكراً	Other
كأنه بيوصل رسالة للأرض ؟؟ اهدى من كدا يا معووود	Hijazi
"بدل ماتفكر تسيب بكرة افضل لولادك .. حاول تسيب ولاد افضل لبكرة\""	Other
خطأ ما له داعي	Other
نعم اتفق معك المدرب ماقصر والمناقشة حول الغنام ومستوى أحمد موسى السيئ لازم يناقشونهم ورانا كأس الملك وبرضو من أمام الاتحاد مانا ناقصين بعد	Other
ولا يوجد غيره يالامير صغير الرياض الازيرق الضعيف اللي مايأكل بيده المدفوع دائماً الزعيق	Other
تجيني والندم واضح ولا أقدر اقولك سم لان الجرح من شافك تضايق قال وش جابك..	Hijazi
#سكري_الان 311 ارتفاعات وقت السفر مازييييينه	Other
علاقتك مع شخص راح تستمر ، طالما ان محد يدري انك تحبه .	Other
المملكه 37مليون سعودي بعد فل	Hijazi
تمام ،ماينفع نرجع لذكريات الجامعة .. شارك واربح ..	Other
شخص يستحق الإعدام اللي إذا دق عليك وما رديت يروح يدق عليك من رقم غريب الله ياخذك يالنشبه ‹	Other
يآ الواتس اب رجع لي امي : ( ! قبل شوي تورينن سمك يطير ، احد يجي يقنعه انوه تسذب	Other
هذا يطلع بداية كل جزء ونتشخط منه حنا الفقراء	Other
"\" الماضي ، قضى وانقضى \" كنت محتاج هالجمله جت بوقتها .."	Other
مشكله عاد اذا نادي بنات داعس وجهك ٢٠ سنه	Other
دزي الله يصلحك	Other
لا بقد خزنت من الفجر حجى قبل اشوي. معني فيها	Other
لا كيفي بتسابقي العصافير	Hijazi
"بعد المتعة التي يقدمها النصر مع \"خورخي دا سيلفا\"..لو كنت رئيس النصر لهددت الجمهور قائلا: بتحضرون في المدرجات بكثافة وإلا أرجع كانيدا\" #النصر"	Other
تعبت أقول هانت ولا تهون، ياربي هوّن على قلبي ):	Other
USER ما اعتقد انه في شي يثبت انه في حمل غير تحليل الحمل. وممكن تعمليه في الدم اليوم راح يبان	Hijazi
برشلونه الشوط الاول استحواذعلى الكورة ولكن حتى الان لم يعرف الطريق الى المرمى بهجمات خطيرة اتوقع الشوط الثاني راح يكون اختلاف من ناحيه مدريد	Other
شفت طيبة الدنيا في ملامحك.	Other
الله لا يحطني مكان اخوك	Other
"سمعنا كثير بـ \" ما يصح الّا الصحيح \". بمعنى ما يصح لقلبي الا انت."	Other
كنت أشوفك شيء وإكتشفتك شيء ثاني #بوح #حقيقة	Other
هذا هو المقرود هذا هو المنقود تبع لتركيا وإيران ماهو بكيفه مجاراة لابياتك هههههههه	Other
اخيس شعور بالعالم تشيلين هم اشياء كثيره و انتِ بالاصل منسدحه و تطقطقين بجوالك	Other
: احترم الشخص اللي ينادي مره وحده ولو مارديت قام وخلص شغلته بنفسہ	Other
قلت لك اسحب عليه	Hijazi
#وش_السعد مافيه اي كوميديا بهالبرنامج بس استخفاف بالمشاهد وتجاوزات غير مبرره	Other
هههههههههههههههه ياحبيبي ولله	Other
ماشاء الله حلوة وللامام ياوحش عقبال مانجي ناخذ دورات على يدك	Hijazi
الاتحاد ماعندك أحد مع ذا السباك .. راح يتأهل السد و الهلال	Other
انا مالبيد حيله اعتمادي عليكم يالذيابه لاتكررو اغلاطكم USER	Hijazi
من افضل العيبه في الشوط لكن هفوه وحده تقلبون عليه تحطيم في تحطيم الله يهديكم	Hijazi
#كلمه_احتاج_اقولها في داخلي كلام درر بس معرف اعبر عنه	Other
USER #المطالبة_بشطب_سالم_الدوسري كنت اقول انه فوتوشوب لكن بعد هالمقطع تأكدت انه صدق URL	Other
هه، لا مو كذا يافراس URL	Other
اضحك مع العالم واوزع نصايح ومن قال كيف الحال قلنا كذا الحال URL	Other
ابي انضم كيف	Other
اكثر من ثمانية أشهر أطالب بتركيب خدمة DSL ولا شي ولا شي ريح ريح	Other
اشوف الشيء اللي بيوجعني قدامي بس ما عليه بتجاهل!!	Hijazi
انا مدري بقابل رجلي ولا بنزل الشرقية قلبي يدق بقوة	Other
السجائر تليق بي، ومن هواياتي التسويق للسجائر، لالا، أنا أصلاً عايز أموت.. يا ابن الحلال على شحم.	Other
USER ههههههههههههههههههههههههههههههههههههههه أصلا الشنطه مابها كتب كتبي بالمدرسه.	Other
العميد يقول ان على السنين القادمة مثلاً- امريكا ماراح تقبل احد يكمل دراسته عندها الا اذا كانت الجامعة معتمدة	Other
صدقيني في الدم ي ربي جايين ندور الفلة والوناسة باقي شسمه الله يزوجهم عشان نرقص ونستانس	Other
اول مرة تحكي صح	Other
اداره الفشل بتجيب العيد في الشتويه واذكركم URL …	Hijazi
انا حاس فيه إسقاط الولايه الله يستر بس	Hijazi
USER ايه علشان تنامون زين	Other
الفرج ، كل مباراة لااازم يستلم الكورة وهوا ف منطقة الدفاع ويلف ويدور ويتفنن وانقطعت قبل كدا وجات هدف، موهوب ما قلنا شي!،بس احترم الكيان ياخي	Hijazi
والدنيا عم بتشتي URL	Other
USER عارضينها لك حبيبتي	Other
فرحانه كانو انجاز لينا #الجواز_الاماراتي_الاول_عالميا	Other
صوت المقص طرب	Other
الموضوع : المغتاب إنسان مايعرفه URL	Other
يا مره انت ما تمثل الرجال انت حدك جزمة ولا وبعد كثيره عليك	Other
هذا اهداء لك ياسامي احسن من 100 جوال URL	Hijazi
إذا ماسكرت حسابك لاتقول القول وانت ماتحميه	Hijazi
اثرك منت سهل	Hijazi
قادره تخليني ابتسم حتى لو ماكانت معي	Other
USER رأسية راموس خلت الجمهور يزعجنا على كارلو	Other
هرجة انو توقفها دي غلط ! الام تبقى ام ولها الاحترام مثلا تحاول معاها وتصارحها اكثر من مرا الين تعرف السبب ومع المحاولة حتعرف	Hijazi
ماقصر ولد سلمان URL …	Hijazi
USER هاللاعب ينطرد في حركته مع برونو	Hijazi
هههههههههههه جزاك الله خير يابوفواز	Other
اي عميل مثله يستاهل	Other
ابو جونز لو انه مستخير ذيك الليله اوفق له ، حرام ذا يمسك حراسه النصر	Other
ادخل ف الناس بسرعه كبيرة غبية جداً .. أحبهم و أبين فرحي فيهم لدرجة يصيرون م يشوفوني	Other
USER مثل ما عكرت صفوك قادر انك تسعد نفسك بنفسك.	Hijazi
مذاكرتي على اللابتوب واهلي خذوه يشوفون مسلسل فرحت اشوف معهم	Other
بس يبقى اكبر خطا تبديل كاريليو	Other
USER اشسم اخوي الكبير	Other
ينفع أكون اختهم بالأسلام ؟؟.	Hijazi
بعد ماطلع من برشلونه، راح تشافي ، إنييستا ، بويول ، فيا ، بيدرو ، اضف الى ان البقيه انخفض مستواهم المعهود	Other
شنط نسائيه ماركة برادا وماركة شانيل كوبي بجوده عاليه(ومنها الوان) ظل 20 لون احمر خدود 6 لون ظل لورا 30 لون مع احمر خدود 6 لون مع اضاءه 3 لون بودره 3 طبقات مناكير لمعه 2 لون عطر شكل بلاك ابيوم 25مل السعر 380ريال W012_ماى_تارقت# URL	Other
بداية بدت تفقد مصداقيتها ، ولولا شباب القريه ماكان تابعكم احد ، الاداره تتخبط وتخربط والفلوس تعمي النفوس #زد_رصيدك86	Other
طيب انا شدخلني؟	Other
من متى الى متى دوامك	Other
انا ما احترفت الاستيك انا نفسي ستيك هاوس يجربون URL	Other
ماشاء الله ها	Other
ويسلم ذوقش أخت رند	Other
شانكس ٪١٠٠ كايدو ٪١٠٠ تيتش ٪٩٨ بيق مام ٪٩٥	Other
كل الم تحس فيه امي ليته فيني ولا يجيها شي	Other
حرااااام لو كملللللت.	Other
الانسان وين ممكن يروح بكامل انهياراته؟	Other
نظام نومي ابو كلب.	Other
الله يشافيه ويعافيه ويقومه بالسلامه	Other
نتحمل شوي عشان م نخسر لﻷبد	Other
وحشه وذكرت جفاك بالمغربيه دم نكط عله الكاع من فرك اديه #دارمي	Other
شهر مافي مشكلة	Hijazi
تسوي خير لو تبعد ولا ترجع .	Other
#حط_تغريده_حلوه خلك شخص قوي خل اللي يشوفك يقول وشلون ذا قوي عمره م ضعف؟ خل عندك إراده وقوة، حقق طموحك، لاتسمع للاشخاص السلبيين والمحبطين اللي يحسسونك انه كل شيء صعب بالحياة، الحياة حلوة وتحتاج خطه وقوة منك عشان توصل اللي تبيه، خل عندك دافع قوي وامل كبير بأنك راح توصل للي تبيه	Other
جاكم الموت يالمفسدين	Other
"مال النجوم اوطان \"دام السماء عيونك\""	Other
كيف اسوي فاالاعلانات احظر في اليوم عشرات الحسابات ولا في فايده	Other
USER ياسدووون اش اسم اخوي الكبير	Other
مسااائك فل وياسمين مسااائك ميسي الليله	Other
خذ سلكي لا سلكي URL	Other
عانس اسيا تسجل رقماً قياسياً جديد بدفع الحكام ب8بلنتي وتبطاح الاتفاق وفزعات الحكم #زعيم_اسيا_يسجل_رقم_قياسي_جديد	Other
الله ايام البيبي كانت تضحك URL …	Other
سبعاه! ماقدرت اكمل المقطع	Other
USER الله لا يفرقكم ياارب..دائما مبدع بتصويرك ماشاءالله عليك	Other
قـم رتـب الأحـسـاس يـالـلـي عليـك أدمـنـت مـابـي ! صـبــاح الـنـاس ابـي صـبـاحـك ' انــت ' .!	Hijazi
ليتهم يخلو ذي العادات مره مو صحي ذا المحشوش وع فكره زمان يسوا المحشوش لحفظ اللحم فقط لان ماعندهم ثلاجات وكذا >>>>>اليووووووم الحمدالله كل شي تطور	Other
USER في ذمتهم << ذمتي بريه اقول ماينفع فيهم الا نرجع نحفظ الفلوس في تنكه تحت البلاطه	Other
َ حتى مع الضحكة : يشوفون جرحَك ! بعض الجروح إنْ صحصحت ، ماتجامل ! - أنا الحزن في صورة إنسان .. يضحَك .. وانتَ الأمل في صورة إنسان .. راحل	Other
#حطططط_سنابك_تابع_يومياتتت_asseeal33 كمل جميلك واسقني شربة ا zyX	Other
نبي اسماء العيبه يلي سجلو	Other
كيف تهواني وتهوى شخص ثاني كيف تجمعناا وسط قلبكك سوى يوم تجمعناا بقلبكك ي أناني من يحب اثنين عمرة م هوى	Other
عليك السلام ورحمة الله وبركاته هلا مستر جاكيت	Other
USER لوووول الظاهر كذ،ـأإ ,,, ههههه	Other
USER USER USER كله من ابو نديم	Hijazi
#عايض_القرني_في_ليوان_المديفر سأل الزمان و قال .. ايه غير الأحوال!!! URL	Other
قول ماذا لا افعل بس لو تتمدد ل ٤٨ساعه افضل اخخخ ببسس	Other
لا مو سلبي اذا مشينا بحدود المعقول ..	Other
USER وين البرنامج ماجاني	Other
#NAME?	Other
وهو شات البارح؟!	Other
USER السلام عليكم سوال ابي اغير الراتب هل صحيح يجلس ٦ شهور علشان ينزل حساب مواطن	Hijazi
مافيه أبديت للجملة هاذي ؟ لي عشر سنوات بنفس الموسم هذا لازم أقراها !	Other
اسامة مافي تحديات جديدة؟	Hijazi
ماخبرتگ كذا ي كنق	Other
ماعندكم رتويت سلف فتره مؤقته وارجعه	Other
ماعليك زود وانت بخير وصحة وسلامة	Other
هذا انتو كل ماسجل اهداف حمدالله وفاز النصر لازم تطلعون كلام حمدالله هداف غصب عنكم 21 هدف	Other
#هل_ترضين_تتزوجين_شاعر ههههههههه الله يعين الشعار ،، طبعا انا بعيد عن الموضوع .	Other
إنا حبيبة سواليفه الطويله ونبرة صوته وضحكته الحلوه.	Other
احسني تعبته من قد م اعيد الاغنيه.	Other
الحمدلله ع السلامة .. خطاك السوء	Other
اول ماتوصل لمرحلة الاكتفاء بنفسك حتكون اسعد الناس حرفياً لان ماحيأثر فيك دخول او خروج او تغيير الاشخاص في حياتك.	Hijazi
صل ع النبي ههههههههه	Other
USER والفريدي راح نحتاجه لصناعة اللعب خصوصا واحنا محتاجين للفوز وضعنا صعب يا اخوي	Other
ارفق علينا ياسديس زمانك ليه شايفني ارسلت شي اباحي	Hijazi
ايوه يا صرمه كيف السد خخخخخخخ مدعوس يا وضيع	Other
صح بدنك خيو	Hijazi
من بغاك ما اتعبك م اوجعك ماقال انِك وطَن ثُم انكرِك .	Other
USER اهلين مشاكس والله اني ماني زعلان فان بيرسي سهل تعويضه مو زي فابريجاس صعب المهم يتعاقدون مع لاعب مهاجم وصانع لعب والارسنال كبيرر	Other
#عمرك_ذهبت_للحج_او_لا الله يكتبها لنا ان شاء الله ونسقط الفرض اللى علينا	Other
تغيُرات البنات صارن يحطن جيوب بالعبايات.. وبعض الشباب يشيل شنطة	Other
#ضمك_النصر النصر ما فيه ظهير يسار ؟!!! غريب	Other
توقعت رويسس اللي يبدل	Other
بيدوسك بحذائه صدقني يسويها انتبه وهو حذركم وقال كل سلقه قائد يقود مجموعةسلق سوف ادوسه بالجزمه بس مسوي قوي إذا انت قوي لاتمسحها ابوفيصل تفاهم معه وشف شغلك. USER	Other
نويتك سر لكن عيوني بالهوى سولفت بك .. #فضفضة	Other
USER USER الله يخلف عليكن	Other
وحش ياششششششراحيلي الهلال_لخويا	Other
١٢٦- مشاركة الطموحات جهّز نفسك للفرص احشر طموحاتك ف السوالف كأنك مادريت، يمكن يفتح لك ابواب URL …	Other
من جدا قالوها مانريد منكم ان تباركون بل تصيحون والاخ ملثم المنشطات يصيح مع نفسه ماله لا ناقة ولا	Other
بيني وبينه وصل وأسرار وعهود مصيونة ٍ ماتدري الناس عنها في كل عام يزود حبه بعد زود.	Other
ايش لمّ تنتون على تنتن واحد نتن والتاني انتن #امثال_حجازيه	Hijazi
عندي فديو يوم زواجي لابوي وهو يدعي لي ب التوفيق انا ورجلي وكلما شغلته امووت الف مره الله يجعله من المنعمين وبجنات العليين وجميع موتى المسلمين	Other
يزعلني الهلال مين يراضيني؟	Other
ههههههههههههههههه سقى ايام ماكنتم تتابعون الدوري	Hijazi
هههههههههههه وش ذا الصياح	Other
عُيونك هدامة الزعل.	Hijazi
USER اللي ذكرتهم جابوا آسيا	Hijazi
وانت تأشر واحنا نقشر	Hijazi
الله يسعدك ياوزير العمل مثل ماعطيتنا اجازة	Other
ما أعرف اني نمت عدل وحللت النوم الا من عيوني	Other
وين تدرجتي علمينا انا استغلت بمدرسة خاصة لمدة ٦ سنين تقريبا بدال ما يزيدو الراتب ينقصوه	Other
هذولا بالذات سلمي لي عليهم جدا	Other
مين هذا عبدالله بن مساعد!!!	Other
غير قلب الدفاع الجناح وحط ذَا وبتضبط معك URL	Other
لا تو اصحى ووجهي صاير نحس	Other
USER فايز لا تكلمني	Other
"احب احط ذي\"\" مع الكلام مدري ليه"	Other
ياعالم خلوه ينقلع ويفك النصر شره والله لا رأيه صح ولا كلام مقنع ولا شفناه بوقت الشدايد يقف مع الكيان متفرغ لأعماله واذا شاف الفريق استقر خرج وجاب العيد سيخسر كثير من جماهيره اللي بيقول غير كذا مع احترامي له ليس مشجع كيان مشجع لاعب وعلموه انه اعتزل وخلوه يعتزل معه من تويتر	Other
اهم شي الاتحاد وش صار في نتائج التحقيق	Other
᷂يا ᷂دار ᷂وين ᷂أحبابنا ᷂اليوم ᷂يا ᷂دار ᷂يا ᷂دار ᷂وين ᷂الحب ᷂وين ᷂المحبين .	Other
يحلف انه ما شافه URL	Other
USER السبب من فوق اقصد المطر خلاص	Hijazi
والله واحشششتني اكثر ياحبيلك	Other
الحمد لله كلها فيني	Other
مالي عيني و أشوفك يا بعد مشتريك دانةٍ ما تتساوم بالمحيط أكمله	Other
USER متعوب على مسرح	Other
جائزة أفضل نومة تحاول تنام فيها طول الوقت بعدين فجأة يشتغل المنبه وانت ماتدري اذا صاحي ولا كنت نايم تروح لاختبار القانون التجاري	Other
USER عطني حبتين دونتز	Hijazi
USER بس البعض تنخدع فيه ماتكتشفه الا بعد بعد وقت من الزمن وممكن انك عملت المستحيل من اجل اسعاده	Other
قلبي لغير الله ما هو بـ راعش و ان ضاقت الدنيا لها الله فارج الله يلعن من يسّمون #داعش أسمّ من سمّ اليهود ( الخوارج )	Other
يقولون البدو مايتبع المقفين فالح راي ، وأنا أقول البدو لا هبلوبك خلك اعرابي !	Other
مافي عندكم تخفيضات لنهاية السنه	Other
USER يسعدك ربي هلابك	Other
الفريق الوحيد اللي رجع بخرقه الصرامي الهلال راجع وهو بطل أكبر قاره والرابع أو الثالث عالمياً	Other
الله يجمل حالك واعمالك	Other
أتوقع ألمانيا وإنجلترا راح يكون لهم دور كبير في البطولة	Hijazi
كود M142 الخامة قطيفه هايدى المقاس m l xl xxl تلبيس ٨٠ ٩٠ ١٠٠ ١٢٠كليو السعر 180 ريال W012_ماىتارقت# URL	Other
الخاص مقفل عندك	Other
صدق نادي فقير واللي يشجعوه فقراء	Other
اكرهه الشخص الي تجيه متحمسس ويرد عليك وباختصار تحسه صافق قلبك كف .	Other
مو فرحانيين بالخساره وهذي مباراه وديه ما تهم الخساره او الفوز قد ما يهم المستوى والروح والتجانس	Other
الحياه مش صعبه بدون اصحاب بس صعبه لما يكون فيه اصحاب وكأنهم مو فيه.	Hijazi
"\" USER : أنا مستحيل أسمع احد يتدلع وما أقلد ‹› اوتوماتيك اقلد سبحانك ربي ‹›"	Other
USER يعطيك العافية أخ يزن عندي استفسار بسيط لو انا ضايف احد من أصحابي معي في الالتميت تيم هل استطيع أعطيه لاعبين مااحتاجهم أو هو يعطيني	Other
اللي يبيني لو ورى الشمس جاني لـو قلت له مــابيك فيني تجــوّد ! واللي يبي فرقاي مهما أعاني لـو مت مـن فرقاه ماهو معــوّد **	Other
ولا يا عرب هجرني ابو عيون السود ولاني بعد مخطي ولاني بعد جاني حرام الجفاء يا سيدي يا دقيق العود	Other
الحمدلله على وجود هالانسانه في حياتي URL	Other
شكلك شايب مثل الصرامي عشان كذا روحوا ناموا الحين موعد نومكم ياشيبان	Other
المنتحل من تغريداته يبدو انه انسان مو عادي وشف كمية التفاعل يحسبونه الرئيس	Other
فخم يا ابن زايد	Other
حبيت شكل التويتر الجديد بالكمبيوتر	Other
USER افتحو فرع بحايل علشان نشريها	Other
يقولون لاضاقت عليك الوسيعة غن وأنا أقول شفت مقرد الخلق وش قالت #مساعد_الرشيدي ،	Other
انا اعرف إنهم كثيـر .. ولكن الكفّه ماتميل اِلا لك ( انتي الكثيييير )	Other
مدري بس دايم اتخانق معوه URL …	Other
يا اجمل من كبر والله . كل عام وانتي بخير	Other
USER فديتك يا قلبي والله أنك ابن حلال .. عسى الله لا يحرمني منك	Other
من الاشياء الجميله ان نص اخوياي هلاليين والنص الثاني نصراويين ووقررنا نتابع المباراه سوا في كازينو والحمدلله راح استانس بينهم .	Other
ما ابغا من الحياه الا نوم عدل..	Hijazi
“ USER : ما ابي يومي يخلى منك ابيك معي كل الوقت.ممكن؟”	Other
وانا مثلك حشمت وحذفتو ههههههههههههههههههههههههههههههههههههههههههههه	Other
. الهوى رآعيه لا يسلا ولا يتّشافى يبطي وقلبه مصّد وعبرته في حلقه ..	Other
يمكن جن مسلم	Other
ذكرني في عمي علي الله يرحمة URL	Other
USER USER طيب يابقردي شيل الطاقيه عشان نفهم كلامك بحر وملح وتصفيه حشا هذا محطة تحليه	Other
خَل ٱلموآصل بيننآ تغريـده ..! عيآ آلقدر يسمح لنا فِ ٱلبآقي ! َ ❥	Other
خلاص يمديكي تاكلي من بعد 35 يوم يعني عديتي وتقدري تاكلي	Hijazi
USER اي فشفاش لازم معاه شطه	Hijazi
وللأسف المدرسة ب/63 رفضوا يطلعوا الطالبات او يتصلوا بأولياء امورهم والأمر والمؤسف من ذلك احدى المعلمات تهدد الطالبات الي تنزل تكسر رجلها لاحول ولا قوة الا بالله	Hijazi
وش الهدايا اللي بقيمة 899 ؟	Other
تسلم يابوديما المهم محبه الناس وفزعتهم الغاليه عندي جلعلنا نفوز بلجنة حن وانتم جميعا	Other
يلعنم الغدره ي بي ان سبورت URL	Other
USER كلي انتي الله يبارك بتس	Other
يستاهل التجربه URL – at drip coffee || القهوة المقطرة	Other
"زادت اليومين هالضيقة معي أو حجم صدري على احزاني صغر صرت متضايق \"انا ..مني \" ومعي من هموم الوقت مايحني الظهر"	Other
عقبال ماتفرح بالابطال	Other
ركز معه عاد	Other
مادري عندي احساس ان بالوتيلي راح ينجح نجاح مبهر مع الميلان	Other
يسعد لي قلبك والله على هالكلام الحلو الله يوفقك	Other
“ USER : حالة المداومين حاليا URL ” منننننننن جدددددددد	Other
رف قلبي قبل اشوفك وقبل لا رمشي يرف	Other
#يووووسففف_ااالبللللللوي كل إحساسي وقلت إنك أهلي وناسي fkj	Other
اذا كانك تقصد ديوان القهوه اسعاره غاليه جداً . مثال براد شاهي كوبين ربيع سعره ١٦ ريال كيف في متناول اليد	Other
لمستين يد جوا ال ١٨ بلنتين لبليرين هدف ملغي بعين تليسكوبية و يجيك واحد يقول بس #ارسنال سيء ياخي عطني حقي و كل تبن	Other
يا ساتر يا عرعر URL	Other
سوالف ليل تجمعنا	Other
أنا مايحق لي العبوُس وعندي بالدنيا أُم مثل أُمي.	Other
USER أعجبني فكرة تغير اللغة ، اذا ابي اهرب من حوار	Other
لازم يستغل الفرص احسن من كدا	Other
في الشانز من الآخر خورآفي URL	Other
ريحونا بالله كارلوس افضل	Other
احس نسيت كلشي بالفيزيا	Other
منورنا ي وحش.	Other
مدرب لا يحمل لاشخصية ولا رؤية .. الله يستر بس #اوقفوا_التعاقد_مع_كانيدا	Other
الفريق عنده حلول كثيره في الهجوم بس سوموديكا مع خطته سته لاعبين في الدفاع فرغت الوسط والهجوم وخلت اضعف فريق يهاجم الشباب وصار الحارس ومتوسطي الدفاع هم نجوم الشباب في كل المباريات.	Other
قلبي وليلي به سرى والِّلي جرى لي ما جرى أمشي وأدوِّر في الوجوه تايه عيونك توَّهوه	Other
ياليت حياتي مثل عيونها ، حتى في زعلها جميلة.	Other
تقولي تبي تفوز علي يالازيرق! #الكويت_السعوديه URL	Other
قاتل عشان الاشياء اللي تحبها ايش ما كان يكون	Other
جالسه اسوي نفسي وجعه عشان م اقطع لحم	Other
مرات ودّك تكون عديم شُعور من تعب الشُعور.	Other
#خالد_حامد_بمسيان لا لا ...ماقال شي ....ف السليم ف السليم ماقال شي وبنفس الوقت ما خلّى شي في خاطره	Other
يارب ارحمني من ها المادة :(	Hijazi
USER حي والله الطله ، ارحب ي بو ذياب وصح الله لسانك	Other
لازم تؤمن إيمان تام إن أي مشكلة تمر عليك ما هي إلا سحابة صيف ومردّها تروح، إنت بس خلها على ربك.	Other
USER اخ علي الله يسعدك بسألك من متطلبات الشنغن النمساوي كشف حساب اخرست شهور هل مطلوب يكون مبلغ معين بالحساب بالكشف اوالمقصد يكون نشط؟	Other
وش ذا الانجاز الزفت ي انا تكفى ركز باقي ثلاثة أيام ع فاينل الميدسن	Other
على العموم باقي البرونزية بإذن الله يجيبونها	Other
سلامات أنتي مادري قبل لا تنامي وش اكلتي	Other
#_جمله_مصريه/شنبك دهـ ححلئهولك	Other
انا اللي ادش البيت متأخر ومعاي بطل وسكران #يلا_نسوي_مسلسل_كويتي	Hijazi
#سعادتك_اختصرها_بكلمتين حالياً اني اشبع نوم .	Other
محشش يبغى يشتري خروف كلما لمس واحد قال الخروف : امبااااااااااااااااااااااااااع قال المحشش : حسافه امباعوا كلهم !	Hijazi
على حسب الشخص اللي يبي يقولها	Other
تغريدات تويتر صايره روتينيه ممله	Other
مالنا دخل محد قلكم تنزلون لاعبيننا	Other
الحمدلله كملت ٤ ساعات اذاكر واخذ بريكات يارب درجه كامله يارب هههه	Hijazi
متعمدين الإصابات يخرب بيتهم	Other
USER كبييييييير يبو سنيد :)	Other
الا على الطاري خلص الموسم ولا شفنا طقم الاهلي الاسود.	Other
شايلها همها ولا تبين الفقع	Other
ههههههههههههه الطواقي مالهم حل URL	Other
شنبك ده هعلعهولك	Other
“تحاول تحط فكرة في بالك وأنت عارف إنها غلط،بس لأنك مو قادر تقتنع بالواقع.”	Other
يا ملحه إلى من مر والا كلامه مر على السمع والا بسمته عانقت عيني ما ألومه خفوقي كل ما غاب تذمر يا ما آخذ سنيني فدوتك باقي سنيني	Other
تبغي زوجه اكيداليوم	Other
الوقت اللي تصحى فيه و البيت كله نايم ، أجمل وقت لإنجاز المهام	Hijazi
اشارك بالفعاليه وعلى طول قعدت افضفض URL	Other
ماشاء الله تبارك الله.. بس وين ساهر عنك.. متهور انت	Other
الهلال وحيدي,مااستبدله ولا يملي عيوني إلا الهلال. URL	Other
الله يسامح ضحكتك نستني اختار الكلام .	Other
والله أحسن علشان يطلعون عديمين الكفاءة من السوق ويبدأون يطورون مهاراتهم.	Other
يعجبني من يترك الناس في حالها ويعيش على مببدا مالك ومال الناس .	Hijazi
كتبت لك زيّ الليله دي في يوم ميلادي ، غِنوه لك تفكرك بموعدك ، اسمعك غِنوتك : سنه حِلوه يا سعيد بدموعي في العيد ..	Other
لو مافي التجميعات رسبت شكلو	Hijazi
الف مبٌروك ماجاك ويتربى بعزك .	Other
كلام سخيف من واحد سخيف #يامنصور_تعالج	Hijazi
راعي التغريده عطان حظر ايس في	Other
تم التصويت وابشر ابشر وانت تستاهل	Other
عقلي الاسبوع دا مسوي فقرة احلام مرعبة	Hijazi
هندى هندى مافيش كلام	Other
بدينا بالتبلي !! وين اسمك باي سطر؟	Hijazi
مافيه احد يبقى لاحد ياقلبي .. لا لا تحزن ابد	Other
اهلا ، ايوا شخبارك شعلومك	Other
الصداع مداوم معي اليوم :)	Other
USER مافي شي جديد حق البي بي للجلكسي	Other
#Warm_Bodies مرة متحمسة اشوف دا الفلم، ابغى اشوفو بسينما :'(	Hijazi
اقص يدي اذا ماكان العنوان رزدينت ايڤل٣ NEMSIS	Other
ولا زال الجلاد يجلد بسوطه المعتاد انا رحمة اعلام القروب من كثر ماجاهم من جلد والمشكلة كل واحد لايستطيع ان يرد الا مره او مرتين بعدها يقول أترفع بالرد عليك اغبياء ضعفاء مملوكين بقروب واحد يحركهم مدير قروبهم	Other
“حناالحكومة وقفنا السومة وجانا مهند واخذنا علومه”	Other
USER نفس الجملة تنطبق علي لماكنت في ميشقان أبغى أهج لأي مكان وكل اسبوع اشيّك بكم التيكت	Other
ناصر الاولى يلعب من هزازي اما السهلاوي من الافضل يشوف شيء غير كرة القدم #ناصر_الشمراني	Hijazi
المصقعه مين صقعها؟ URL …	Hijazi
وإن بغيت تحب، حب الثقيل اللي إذا مر غيرك مايبتسم له..	Other
واذا مو اهي اكثر شخصه تعزز لي بكل شي .. URL	Other
اترك من المسلسل الحضاري اقصد التاريخ اكثر مسلسل تاريخي عندنا بالخليج تكلمو عنه تدري ولالا URL	Hijazi
ابي فحل رجولي وسيم يريحني. #معصيتي_راحتي	Hijazi
اول مره احب اجواء الشوي وارضى فيه.	Other
USER وراه ماأقدر اسوي لك رتويت :-(	Other
بكيفك اي شئ حلو منك	Other
خلاص ماعاد ابي تنطق ولا كلمة عرفت قلبك وشنهي اآخر اخباره شخبار عييينك	Hijazi
USER تاكد من الي سمعهنت منهم وخل منك الحذاقه	Other
#االسعودية_الأرجنتين المنتخب اليوم ابدع .. ومستواه تغير اتمنى يستمر عليه والى الافضل ما توقعت كذا ٠-٠ تمام عليكم يا الذيابة	Other
دام عز الوطن وحكامه للإبد يعطيكم العافيه	Other
مافيه مني اخر حبة #تحبها_تزوجها_ياخي URL	Hijazi
والله اصكك بواحد اخرج الكذب	Other
ههههه فله فله م يضحك	Other
بس حلوه دوري من اربع فرق	Other
حتى انا ابي اصير أُم بدون م اتزوج. URL …	Other
كلنا نغلط بس المشكله محد يغترف بغلطه.	Hijazi
"- ترى مو لازم تفهم كل شي بالحياة خلاص تنفس وانت ساكت \"̮"	Other
شوفو من يحلل و يتكلم عن الحظ من متى تفهم بالكوره دامك تشجع روما و الاهلي	Other
احاول اطهّر اذني شوي URL …	Other
لما اقولك احبك مو شرط الحب اللي خلاص انتي لي حقي وذا ! لا فيه حب لطيف يسعدنا من جوا بدون ألم يعني احب وجودك بحياتي بشيء اصح ؟احبك معي	Other
مب ضابطه في البداية لانكم ما تغنون على نفس الkey بالمناسبة ضبط الهارموني بين صوت ولد وبنت اصعب من ولدين او بنتين..	Other
نوَيت أوقف على حيّلي ، وشتَتنيَ الحنيَن وطحّت '*!	Other
شيلة عود علي { وين الوليف اللي جفاني } كلمات عارف بن درهم الوايلي اداء درمان	Other
جاهل في أصلك بعد! وجاي تتفلسف! لعلمك ماكنا متخلفين والبيدوفيليا معروف هالمرض طلع من اي بقاع العالم وتشوف الفرس الي مايبعادونك جايز لهم لكن حنا ماعرفناه ولو عرفناه كان فضحتنا اشعارنا من الجاهلية ولين النبطية ولا سمعنا بقصص زواج مقززة مثل الي غصب تروجون لها على حسابنا	Other
USER بكرة تحت الصفر	Other
USER تعال مسوين لحم	Hijazi
مرابط ماهو موجود الله يستر	Hijazi
ي حلوك انا والله ي حظي فيك	Hijazi
بيني وبين النُوم شلفا ومشعاب اسعى معه لـ الصلح ويقُول بدري .	Other
الهيئة مو من ممتلكاتك انت موظف ليش تغرد من حسابك الشخصي بقررات المفروض تصدر من حساب الهيئة	Other
USER USER ما يامر عليك ضالم	Other
عيـدي مبارك فيك ياعيد الايام حلـوه سنيني فيك ياعيـد روحـي	Other
لما أجي أرد على أحد يمدحني URL	Other
يوم انك تسأل ؟! انت تحبني جدا وبي مهتم ماكنك تدري ان حبك على قلبي مرابيعه وودعتك وذا دربٍ لابده واسلم وتسلم على حب الشرف واللي نقاه اكبر مطاميعه #5 تمت	Other
ام عموري الله يسعدك انا تاريخ التخرج كتبته تاريخ مجلس الجامعة ومعدلي ٤،٠٢ وبالموقع ٤،٠٢٠ هل تاثر بالمطابقه	Other
#اخرسي_يالجين خير اش قالت	Other
ماتشوفي شر ياعيني	Other
ماتهون ويسلم راسك وتستاهل وصح بدنك وكفو يابو ياسر	Other
#كلنا_ثقه_في_محمد_بن_سلمان واصل وكلنا لك سند وماعاش من يحاول ان يجعلنا نرضخ رضوخنا لله وحده فقط	Other
USER الله يطعني عنك ياشيخ	Other
يقول #شريان_الديحاني. اصعب سؤال يمرني في غيابك شنهو مصيرك ياغلاي ومصيري؟ URL	Hijazi
#اكتب_لنا_تغريده_وانت_مغمض عاةعشخخؤتةيةحسزيةةيو تة سويها سوت .	Other
الله لايخلينا منكم يابو عبدالله انتم عصابة الراس وحزام الظهر وانت شخصيأ واحد منا	Other
USER : تاخذني الذكرى و تاخذ ضلوعي وأتذكر إني كنت .. في يوم جنبك يطري علي شطر يهيض دموعي أيام حلوه كانت أيام .... ( حبك )	Other
محاط بيهم فى الجيش فى كل مكان ... URL …	Other
USER أهمم شيء يؤوم طلع المحفظة	Hijazi
#اجمل_صوره_من_تصويرك مع احلى ناسي URL	Other
USER يالي متمصدر علينا	Other
فيه مقهى بيات مراا رايق جربه	Other
ههههه صباح الورد والبرد	Other
اجل انتي ولدتي بحقبه غير هذي .. سوي تحديث .	Other
العقل والوجود ما عجبني	Other
معاد أبي تركب الددسن URL …	Other
اهلي يقولون لي طلعاتنا تخرب بسبب نومك، والحين لي يومين اصحى بدري ومايطلعون دليل انهم يدورون الاعذار بس وحصلوا نومي	Other
ممتاز ويجيب نوم	Other
المشكل اللى تحبه #CAZA #مكسرات #محمصات_كازا #تبوك #تبوك_الان URL	Other
وين الدرب هذا	Other
اخيرا لقيت احد زيي	Hijazi
من وانا صغيره كنت اتمنى دا الشي.. URL …	Hijazi
"المقصد من \"حطيتك بعيوني\" إن العالم كله صار وجهك."	Other
راح ابقى على بالك وانت ادرى	Other
سكّه طويييييلة وأغنيه..	Other
اهدافنا وين انشاء الله	Other
لا والله ماجاني شي	Other
على اساس الاجنبيه بتخلي عيال بلدها المزز وتجي عنده!	Other
كمان التعليم الطبي أحس ينفعلك يا أبلة بشائر من يومك أبلة وأستازة عظيمة	Hijazi
#طقوسك_بالشتاء مخيّم ، كرك ، شبة نار	Other
شكله توه محلق.	Other
تقول نُوال: وش يهمك لو رضيتّ؟انت ما تعرف تحبِ؟.	Other
على خبرك قليل النّاس في عيني ويا كثرك	Other
العفو يا روحي	Other
كويسسس توقعت شي اكبر	Hijazi
يبب مثلي ذاك اليوم جبت لقطات الارررض وطلعت مسوي مثلك .	Hijazi
احب اشكر التويتر محتفظ لي بصور ومحادثات من ٢٠١٤	Other
USER الله يرحم والديك ادعمنا ياشيخ خبره عشر سنوات في سوق الاسهم السعودي	Other
من شقك هههههههههههههههههههههههههههههههههههههههههههههههههههههههههههههههههه	Other
ورني عشان اتنمر زياده	Other
كل شي حلوووووووووووووووووو في شهر رممضان سبحان الله غيرررر هذا الشهر #احلي_حاجه_في_رمضان	Other
وانت ماشالله فرحان	Hijazi
اصصصص لا ادعيلك الشعله	Other
السبب الرئيسي في كوني ما احب اكون علاقات كثير,هو اني ملول واحتمال بأي وقت اسحب نفسي.	Other
USER يمكن يحطه احتياط عناد في الشمراني اضم لاعب مصاب ما قدر يكمل 45 دقيقه ؟ يدل ان عندك اداره ممتازه يحسدون عليها	Other
وه النونو الجميلة	Hijazi
وحنا من المنتظرين يا افضل معلق وأفضل شاعر	Other
ياكثرهم النسويات في تويتر	Other
افضل قرار والله بدال ماتروح كل مره ويقول والله البصمه ماتشتغل	Other
الكلمه ماتكفي لكن هذا اللي بيرجعنا للهاويه مع اللي مخليه URL …	Other
هبال هذه مو بوق	Other
ياحبيبتي ان شاء الله ترجعين لها بالسلامه يارب URL …	Other
وين في نجران	Other
الحين يقدر الواحد يخسر من الاتحاد وهو مرتاح	Other
م تنباس شفتي م توصلها شفة ثاني حتى تشوف شقد أحبك أني.	Other
لحد يصدق الوعود كلهم يخلفون فيها.	Other
لهالحين كل ما انتظرتك قبال الباب شجر بيتنا..مع كل نسمة يعزّيني.	Other
USER اش اسم الموسسه	Other
لو كان صحيح. ايش الغريب. حرامي ابن سته وستين كلب. هو وقردوغانه. وعصابتهم.	Hijazi
حلو هانت م بقى شي باقي ١٠ سنوات وشهرين	Other
معنى الكلام هذا : أن الحوثيين يجاملون المخلوع على حساب اليمن وأبناء اليمن ودماء أبناء اليمن .. يعني بالعربي شغل عصابات ومافيا حلَّت باليمن .	Other
عندي فهاوه مب طبيعيه والله درج معليش وفيني غباء خخيييرر	Other
USER طلبت بيتزا بيستو ومافيها اي صوص بيستو !!!؟؟ URL	Hijazi
تدري انها نكتة من سنوات؟؟	Other
USER خالي حط الجوال شووية... ما حدق عليك دحين.. اديني عشرة دقايق وادق عليك	Hijazi
ان البلا بأخطاء واضحه تبي هالبلنتي تبي البليهي المفروض ينطرد بعد ما دف المولد وقت الفاول ولا بوتيا يكفيك ان ب ٦ مباريات لك ٦ بلنتيات فريق واطي	Other
"تعبت أدوّر في البشر حب وإحساس تكفيني الوحدة ويكفي مكاني مااحتاج أكون إنسان ثاني مع الناس أحتاج أكون إنسان ماهو بـ ثاني\""	Other
في اولى متوسط سواها فيا السواق رايحة المدرسة فتحت الباب عشان انزل مرت سيارة مسرعه فقفلت الباب مشي يحسبني نزلت مو هنا الفهاوة ما اتكلمت الا بنص الطريق	Hijazi
USER أنتظر طبعا تصيرين لي شوقر مامي بعد مم تتخرجين وتسوين مقهى ب أسمي وتسفريني ع حسابك .	Hijazi
وش بيصير لو اعترفنا اننا فاقدين بعض ؟	Other
الله يبارك بايامك اخوي عيسى ويجزاك خير	Other
shehrih07 @ USER محد يحس الا لاولاده	Other
فيك ولا فيه .	Other
مره وحده بحياتك جرب تفاجئني مره وحده بس!	Hijazi
اذا على كذا خل يلعبون بعد بحوش بيت ، نادي يحمل اسم منطقه حائل وعادي عندك !!	Other
مؤثر ولا مش مؤثر URL … URL	Other
ونعم مليون من زمور القبيله ولله يطول بعمره	Other
USER زيك انا امس	Hijazi
ترى أشتقت لك تفرق عن اشتقت لك	Other
USER هههههه معليش ي كابتن منتو قد النصر	Other
شف التغريدة اللي تحتها طيب	Other
ودي اصدق بس قويه قويه	Other
يستاااهل عمنا روي	Other
معليش لا أجيد النقاش مع حمير جحا ... كما يحلو للإعلامي عبدالكريم الجاسر تسميتكم	Other
رحمة الله عليك ي ابوي علمني على نفس ذا لاندكروزر 1989 #اول_سياره_سقتها URL	Other
بندخل 2020 و هو لسى ثانوي	Hijazi
استودعتك الله ي عيوني	Hijazi
USER كيف عطلتي كيف ؟ من متى وأنتِ تختبرين !	Other
"\"الله يذكر ضحكتك بالخير\""	Other
كذآ شكلك إذآ جيت تدخل بيتكم ومليان حريم ،،! ههههههههه يآكثر مآحصلت لي &lt;&gt; URL ”	Other
انتو ماتفكرو ابدا انكم تطورو خدمة العملاء حقتكم اقسم بالله شيء لايطاق نص ساعه عشان تردو علي وبعد هالوقت كله تقفلو الخط مين قالك اني ابي اقفل كل اتصال من ثلث ساعه لنص ساعه وش هالفشل الي عندكم	Other
#شخصيه_مشهوره_ودك_تقابلها هي مزه بس ناسي اسمها	Other
الاحزان ذي الايام كثرانه علي شسالفه؟.	Other
USER الله يوفقك يارب وتوصل لهدفك :)	Other
USER فيه نادي اقل من كذا بكثير ممكن يادوب يكملون درزن	Other
بدال حمد الله	Other
فعلاً تروق لأي شي ثاني تسويه	Other
قـل للعيـون اللـي تتمناك تبطي مـامن احـد يقـربـك وانـت لـي..	Other
مين سمعك يبني والله URL …	Other
USER أيه فيه اختبار للمرحلة الثالثة انتي ؤش تخصصك	Other
صح الله لسانك وكل عام و أنت بخير	Hijazi
ههههههههههههههههههههههههههههههههههههههههههههههههههه الله لاياخذك	Other
حتى المكان اللي تمرّه تعطيه روح .. هي غافلة بس المكان الي تمرّه منتبه	Other
والله كنت ناوية كذا برحلتي كان نفسي امرها كذا بس واحد من الحسابات استشرته ونصحني مانسويها انها متعبة اللحين جد تحسفت يوم قريت كلامك انه عادي ممتع	Other
بريت ذمتي منها ماعليك	Other
الله يبارك في ذريتك يابو مانع	Other
يا غايب ليه م تسال عن أحوال الي بيحبونك ؟ :	Other
لما أبتعد عنك ما يعني إني كرهتك بس مليت أكون الشخص اللي دايمًا يبادر بالكلام؟.	Other
مامعاه حق صراحه	Hijazi
يارب يمزحون توقعت الحرب قامت #خميس_مشيط	Other
#سنابات_هند_القحطاني هذا اللي يستحق النشر اللهم أجعلنا من أهل القرآن وارزقنا حُسن تلاوته URL	Other
رحت قبلنا ليه السحبه ذي مالها داعي ترا	Other
يلمّنا بكره الشتاء و تمطر سمانا و نلتقي .	Other
قلبييي يارب+عرفتك يقلبي محدش يعرفني غيرك فالكلية دي اصلاً. URL …	Other
يآرب دوم أيامنا سوا .	Hijazi
اشتركت في نتفليكس شهر تجربة مجاناً وقبل لا تنتهي الفترة راح اسحب عليهم خخخخخخخخخخخخخخخخخ	Hijazi
لما مافيك تفرق بين الوهم والمنطق	Other
لو العيون تضم في الناس مخلوقء والله لأضمك بالغلا في ،، عيوني♡	Other
خلاص من حبكم يا زين عزلنا معاد لي في هواكم شف أو رادة	Other
الله يعينه عليك صراحة	Other
#فساد_وظايف_جامعه_حايل درجة الاختبار وأنا ما اختبرت ومقدم ومستبعد	Other
مسوي تغار انت وياه	Other
واضح جدا ان لعبة DS ماتقدر تشبهها بأي لعبة او فلم ، حتى ماتقدر تقول انها ماخذه شي من لعبة وشي من لعبة ثانية .	Hijazi
ابيض وجه يا ابو سعد	Other
عطنا واحد همبرغل بالجبن #تويت_كأنك_في_التسعينات	Other
ازبل كويتا بيضيع	Other
لو تدري قد ايش احبك وقد ايش فيني هوس لك..	Other
3:10 بتوقيت جدة تبدأ اجازة الاختبارات من الدوام ياخوفي افلها في الاجازة وأجيب درجاتي شمال اهم شيء الراحة والنوووم ودعاء الوالدين	Hijazi
المشكله في بيستيك النعجة البسمع كلامها	Hijazi
ينصحون الواتس اب الله يحفظك.	Hijazi
ياالله بكره دوام والله مو وقتك	Other
الله يبارك فيك ويجزاك خير يابو سالم	Other
اكثر شيء نرفزني بالشهر هذا كله	Other
الحمد لله ع كل حال تتعوض في الجولات القادمه	Other
USER طار به قريح الله يعافيها ولا يبلانا	Other
احتاج شخص يفكر بدالي ويعطيني الشيء الصح.	Other
انت العينّ و محد يقدر يشوف بدون العين	Hijazi
صباح الخير بطريقة أمي هذا والله الصباح الحلو.. ألا يا ليت كل الناس تشوفني زي أمي URL	Hijazi
الله يبارك فيك كابتن خليفه.	Other
وانتي بمثله ي مرحبا	Other
تخيل بس كم عاشق يخون بها الزمن ظله..	Other
احساس جميل لما تأثر على شخص وبعد فترة يجي يشكرك لأنه بسببك بعد الله غيرت حياته للأفضل	Hijazi
استمتعو انتم تكفون وتوفون	Other
تعال خاص عساك جاد	Other
USER USER USER خلاص عبى شاني هالمره باتحطو مكياج انا بقدم معروضكم هاذا وان شاء الله نشوف لكم حل غير المكياج	Other
ابيك تعرف اذا ضاقت حياتك يوم ومن حولك تخلوا كلهم عنك وما تدري على منهو يكون اللوم بعد ما خيبوا امالك وظنك بتلقاني مثل اول وباقي دوم احبك اكثر بواجد ترا منك انا عونك .. انا ظهرك الين تقوم وانا ناسك وانا اشيل الحزن عنك	Hijazi
يهناكم مثلها يالامير واعتذر عن التاخر في الرد	Other
عاش وصح لسانك	Other
من غير داعش بذتنا دواعشها	Other
USER مساء الخير عارف ، إذا ممكن أتواصل معك أحتاج بعض الاستفسار منك .	Other
والله ياشق صدره شق ههههههههههههههههههههههههههههههههههههه URL	Other
يرجال لي سنتين ف تويتر ولا شفت شي	Other
ياخوك عن تجربة واحده تعرف لاطيران ولامطار ادفع فرق ٥٠٠ ريال ولا احجز مرة ثانيه عليها	Other
احسن مسوي ظريف .	Hijazi
USER وش قومها حمرا	Other
مو طبيعيه حرقة قلبي لما اغار عليك منهم.	Other
النفسية تحت الصفر والله	Hijazi
الصوت قومن من النوم~ركضت أحسب مكيف عيالي انفجر ورحت أناظر مع الدرايش مافيه شيء قلت أكيد أحلم :(الله يحفظنا ويديم علينا نعمه الامن والامان	Other
يعني متى راح اصحى من عز نومي على صوت المطر والرعد :'(	Other
قلبي تعب منك .	Other
USER مخك و مخي أنا كمان صار كذا =)) URL	Hijazi
وه الله يعينكم يارب	Other
في ضمتك شيء ماهو ب معهـود شيٍ يرد الروح من أقصى وجعها ||بٍــّري حــاالــًيֆ'ء||	Other
ياختي عليه ، ما الولد طلع رومنسي اهوه	Other
السلام عليكم بغيت اسئل اي فرع في الطائف يوجد فيها جهاز قياس الدهون داخل المحل	Hijazi
بثواني يسحبون مدعين المثاليه	Hijazi
ايوه صداع الجوع اللي يعلمك الله حق وتاكل غصباً عنك	Other
فارس ما قدرت ألعب كثير الاسبوع هذا و جبت غولد 3 .. ايش بتكون الجوائز الحمر ؟؟	Other
وربي لعبي يفشل الييييوم	Hijazi
نعم اللي يغليك واللي يكرهك جعلنا الله وأياك ممن أحبهم الله وأحبب خلقه بناء	Other
والله ذا اللي يستاهل امه تقوله البنات يتمنونكماشاءالله	Other
يع اكثر من كذا هم وقلق ماشفت	Other
يآخذني آلحلم من يّدي و يجبرني آشوف منهو رحل عن عيني و هآجر لـ صآر آغلى بشر بالضيق يتركني مآ هي غريبه اذا شفت آلفرح غآدر	Other
طيب وش العلاج يا دكتور	Other
لا اله الا الله حتى صبيا مو مكتوبه URL …	Other
هدية كارليتو ولا ضيع الاتحاد لين قال بس	Other
انا ما سويت مثلك ليت تٓحمد فيني ربك !	Other
مو ملاحظين افنان الباتل سايره زي دكتورة خلود في طريقة تصويرها للاكل.	Hijazi
اقسم بالله شي يشهي بس هذا مقلقل وإلا كبده والا ايش من كثر ماني فاقد الاكل ماعاد عرفته URL	Other
ماتعبتو من الصياح	Other
USER يااخي ماتستحي من. المكذب	Other
الكيف له عاشق والكيف معشوق ولا تدس السم في ضحك سنك هههههههههه	Hijazi
أهلاً هلا باللي رجع عقب غيبه يا مرحبا ترحيبة الناس بالغيث هلابك مليون ... #النصر_الوحده URL	Other
مافي احد ف الدنيا نفس ضحكتي انا غييرر	Hijazi
فيه ناس تؤمن بالابراج؟	Other
رجعولي مضاوي في قروب صحباتي عشان لا تجيني نفسيه منهم والعياااذ بالله	Hijazi
_ والله إني بـ الطويل المستقلّي .. URL	Other
ها اختصري المسافه واسلكي شطر المعده وارتاحي	Other
ما به جديد إلا إني أعدّ الوجيه اللي مضت وكل ما يجي وجهك أعيد	Other
"شعـاار هذا الصبااح \"مـرني اذا الوقت يسمح لك وتقـدر\"."	Other
ملاحظ انت ههههههههههههههههههههههههههههههههههههههههههههههههههههههههههههههههههههههههههههههههههه	Other
مافي أكره من وجع المعده	Other
والله حلو يعطيك العافيه.	Other
يستاهل ابو سلطانه ونعم الأخ والصديق	Other
ماعليك زود آميين يارب، ماسوينا إلا الواجب متعكم الله بالعافية وحفظكم	Other
يادنيي بدي حبيبي.	Other
شفايف نفسها تجنن	Other
يسلمك ربي ياغالي URL …	Other
فاكر لما تقولى هسيبك يعنى انا هجرى وراك؟	Hijazi
هذه وهيا مو مررره قاصه وتقول كذا لو قصت لين كتفها ايش بتقول .	Hijazi
مسويه طالعه منها يكفي انك كتبت في التاق	Other
يجنننن اه بس	Other
- بسمعك شطر له الصوت مبحوح فرقى الحبايب جرح ماله مداوي ..	Other
وشلون تبيه يجيبلك لاعبينه لعندك يعني !؟ حمار هو تحسبه مثل مدربك	Other
انت عاهه مسياري رقاصه في مدرجات خصوم الهلال والنباح من شيمك	Hijazi
الله لايكسر لي جناح #ساعه_استجابه	Other
خنتي هقواتي وضنوني ورجايا	Other
اصبروا باقي الدوري خلوها تكتمل الإثارة	Other
مغرم مغرم انا بيك على طول وانا صابر و صبري في هوايا دليل	Other
ياقلب صدييييقك وشوفته	Other
الله لا يربحكم حرقتوا دمنا ورفعتوا ضغطنا..	Hijazi
مافي طب في بيريز وعقليته الريال يفقتد ثلاث لاعبين نيمار وبوغبا والهولندي بيك غير هذا الوسط، الحالي تركيبه انتهى مفعولها تماما كروس مودرتش ايسكو وفوقهم بيل ولوكاس وناتشو الفريق يحتاج دماء جديده	Other
قليلة ادب ؟ طيب كثريه	Hijazi
الله يجزاك خير '	Other
*الكيميا* زي العسل على ألبي هوااه	Hijazi
صدقوني مافي أحلى من لما تكونين على السرير ومشغله أغنيتك المفضله	Other
اصصحك تصدق لا لا يسلاك قلبي !	Other
حلو لما تأخذ درس انك ما عاد تتعلق ولا تضحي ولا تفضفض ولا تحب ، تعيش لنفسك وتحب نفسك وتكتم حكيك فقلبك .	Other
ضريبه انك متاخر وعندك اختبار تبلع ساهر	Other
اسمها لولو ولا سلمى ؟	Other
سميلاك من نوع اخر لكبار السن اللي ماعاد فيهم اسنان	Other
↓˓❁⸀ء مالي مزآج آسهر ومآلي مزآج آنآم .. مآهو حزن , لگن مآني على بعضي ! ﴿ 'ء ﴾	Other
USER من جد انتحر احسن من هلحركة	Other
طيب لو جيت بصدم تفتح الشنطة؟؟!! مااااش	Other
انتي اليومين ديل اذا مشيت نمله قدامك حتأثر فيك	Other
USER بعطيك ١٠٠٠٠٠٠ بمية ريال وش رايك بالعرض	Other
إذا تزوجتها تبناني بليز	Other
#كم_راح_يزيد_وزنك_في_رمضان اكيد بوصل ١٠٠ وراح اصير برميل يتدربى .	Other
لما اتهزأ من شخص أحبه؛( URL	Other
ههههههه اي والله	Other
فيه تفاصيل صغيره تخليك تتعلقين بالشخص بالمُقابل فيه تفاصيل صغيره تخليك تتركينه.	Other
ورينا جوك في الملابس خلينا نكحل عيوننا	Other
فعلاً قلت ادب الواحد يدخل خاص علي شخص مايعرفه	Other
الموضوع بسيط صرنا متعودين مافيه جديد اللهم لك الحمد ع نعمه #الدفاع_الجوي #نجران_الان	Other
اللـﮧ يسعد روحك وقلبك وعمرك ياكل الغلا	Other
هيضوني يوم غنوا وانا فاقدلي حبيب قامت ضلوعي تراجف وعيني دمعت	Other
ضيعت بس حبيت	Hijazi
USER كأنو حاس انو جايين ، مو حضرتو متعود يخرب على وجهنا كل مره !!	Hijazi
صااااح الشاطر حسسسسن صاح خلاص طلبناك يااالبكيري	Hijazi
عوداً حميداً عاد لو تكمل وتعود للسيديا الله	Other
أنشهد ..إني يافرحةة زمااني لكك « اشتقت »	Other
اص اص يابو سته لك وجه تتكلم	Other
يا مسافر ياشينها عقبك مدينه..	Other
الف مبرووككك لفريق #للنصر تحقيق بطولة #دوري_كأس_محمد_بن_سلمان_للمحترفين يستاهلون	Other
السعادة ممكن تيجي على شكل محاضرة مليانة صور	Other
البليهي يعامل الكورة معاملة القنبلة ياعمي اركد شوي والله ماتنفجر بوجهك	Other
ساره قلبي ممكن حساب اسما الواكد بالانستقرام — soum1414 URL	Other
تعبت من الجفا لاني ابيه بخيره وشره ..	Other
محد هستر أبد ،	Other
اعرف بنجور بس	Hijazi
ثقيله علّيا الأيام اللي ماتجيب لي وجهك!	Other
"\" USER : خلني في عالمك أغلى حبيب .. وخلّ هالأيام تفعل ماتشاء\""	Other
مساكين حنا ذبحتونا	Other
الطريق اسفلت الى حد المسجد في بعض اجزائه يضيق ياله تعدي سياره بس في المجمل جيد	Other
أحتاج أحد يعطيني كف عشان أقوم أذاكر.	Other
#تقليد_هامور المنشن يعلق مقدر ارد ، الخاص ممنوع ، واخرتها يرد على المزز ويسحب على العيال الخروف	Hijazi
طيب واللي يتزوج مسيار وبالدس هذا يعتبر خاين ولا ايش؟؟!	Hijazi
ججاننغغ يا جانغغ	Hijazi
USER USER السلام عليكم اختى ممكن اسئل عن فتامين حق وش	Other
بكره الحفل مو اليوم	Other
USER منور المتجر يا ابو نوران	Other
كلمته على تغريدتك هذي	Hijazi
آتخيل وجهك الزين ومسي عليه كل وجهٍ غير وجهك ما يغري ناظري أنت من حبه خذاني من العالم إليه وأنت من شوفة محياه سلوة خاطري	Other
في الآجازة عمره ١٠ سنوات وحاط بآك تركيآ وانايوم گنت بعمره انتظر متى يغسلون الزوالي في الحوش عشان اتزحلق ههههههههههه الدنياء حظوظ~	Other
أولا الحكم الإماراتي ماعنده الصلاحية انه يلغي أنظمة وقوانين الاتحاد الدولي للعبه ثانيا ما تخلون خستكم وحركاتكم التافهه من فبركة وتدليس والدليل عدم ارسالكم للمقطع كامل وقصة حيث ان اللاعب ذكر اعتذار رييس الحكام الإماراتي ثالثا :-هل قطر تستطيع رفض قوانين وانظمة الاتحاد الدولي URL	Other
صباح الورد وش ذا العصير	Other
كفوك الطيب يابو عبدالله	Other
صدفة وجمعتنا والأماني خذتنا ياجمال الصدف لما الفرصة جتنا العيون ابعدتنا كل شي اختلف	Hijazi
مايدري ان شراب كاريو اغلى من المصور وتاريخ نادي النصر	Other
اعطونِي اسماء روايات حُلوه وما تكون ممله وطويله؟.	Other
بقعد معه ساعات و لما اجي اروح ببعتلي عالواتس اب كيفك :نفسي انط عليه ادخل ع دماغه اقطعله العصب اللي بغذي اصابعه اللي بكتبو ع كيبورد تلفونه :|	Hijazi
اذكر كتبت عند احد بس مين نسيت ؟؟؟	Other
يابو زاويه اذا المسافة كافية يقجر القناص يطيح حظ السلاح ذا	Hijazi
USER العيال في أبها الشيبان حول النماص	Other
ما عندي طاقة اتناقش معاك	Other
USER USER لاتصدقهم مابيتواصل معك احد لي ٣ايام انتظر غير خدمة العملاء ٩٠٢ والمشرفين اللي حولوني عليهم URL	Other
اتفرج بقا ياعلوة علي بي اوت	Hijazi
انت يابو حمود شهادتك وسام ، استاذ علم ومرجله ، ومعرفتك نوماس الله يطول عمرك على الطاعه	Other
الكوره اعمته ماصار يفهم الذبات	Other
اهنيك على الفكر تجيبون حكام اجانب سباكين ليسو معروفين،على الساحه الدوليه ليفعلو الكوارث في المباريات وتقولون لابد من علاج الفكره واضحه ومفهومه لكي تعيدون الحكم المحلي وللاسف الاعلامين من بعد مقولتك (حيوحشنا ) لو قلت الجمعه قبل الخميس،قالو نعم المفروض يئسنا وحنا نطالب ارحمهم	Other
غالي والطلب رخيص #القمه_الخليجيه_40 #صباح_الخير URL	Hijazi
ولك بيرقن في القلب حبك يهبّه شامخ ولاهزة من العذل غارات	Other
USER . لأن يلعب معع الهلال ... وفلوسس له دورر	Other
نفس كلامي متوقعه لأبها يستاهل نادي كبير	Other
يبقى الغلا للعوامر كلهم	Other
URL … ايش رأي سعادتكم في وضع الصناديق ... USER USER	Other
قلت لأبوي أبي حبر للطابعة صحيت شاري طابعة جديدة !	Other
USER ههههههههههههههههههههههههههههههههههههههه حرام عليكككمم رحمتها من قلب و خدينا ذنبها إستغفرالله	Other
تُجافيني! وتسأل عن سبب هالحزن! مو حزينة هناك ثقبٌ بالقلب يؤذيني.	Other
بس هو ماكذب ولا قال شي خطا او محرم او منهي عنه كلامه سليم	Other
صرخت من الضحك هذول شكلهم يقربولي بالغلط URL …	Hijazi
USER مافي شيء غريب.	Other
مدري الى اليوم توله على مضناك واﻻ أنتهى حبي ياقايد الريم ذكراك ماغيبت عن خاطري ساعة الروح لك ياساكن الروح نزاعه...•♪	Other
عسى اللي نوى قرّبك،يموت الحظ ماطاعه.	Other
شقصدددك يعني مب حلو انا؟	Hijazi
هو جابها على نفسه اذا استضافوه اخذ يحلل عن سامي الجابر	Hijazi
اخ يالغبنه ذا مكمل والفناء لا	Other
USER ايوااا يلا جيييت +---------------------+ الله الفيااتي عشششق	Hijazi
يارب يصير عندي ملايين وأقدر اساعد كل الحيوانات ولايهونون الناس	Other
USER ابكي ولا اصيح خلاص خلوني متماسكه وبطله 	Other
الدقيقه ١٦٣ الشوط الثاني للحين	Other
والله أفخم لايك ف حياتي	Hijazi
#الهلال_النصر أشوف ثقة مفرطة من جماهير الهلال بفريقها ولكن يجب بأن لاينسوا أن دونيس يجيب العيد في المباريات الكبيرة , لذا فإنني غير متفائل	Other
USER والله مادري ممكن تحصله عندهم!	Hijazi
USER وهذي الصفحة فيها شرح كل شي URL …	Other
اقفى صيبها واقبل زغيبها	Other
المرتبه كم ؟ وبعدين التدريس اذا إداريه روحي العدل أفضل أما إذا مدرسه يفرق .	Hijazi
قدع يا ثلب	Other
اقول رح اشحذ متابعين لسنابك وانت ساكت	Other
USER جعلهم فداش يابنت	Other
ياشين الضيقة الي تجي فجاة	Hijazi
لسه .. وصلنا مرحلة الصديق و القادم أجمل	Other
انشهد انك اخو وسند وصح بدنك لا عدمتك وعسى عمرك طويل يابو علي	Other
وربي منجد مسوي نفسه رياضيات تعبني	Other
وبعدين من اللي قال لك يا بو يهود اننا زعلانين هذا المقذوف ردة فعل للأطنان من القنابل والصواريخ التي تسقط على رؤوسكم وعملاؤكم...	Other
تسلم والله يهنيك بالسلامة والمحبة والعافية	Other
ياالله مع السسلامه مثلك مايحس بندامه	Other
يلا نكثف قراءه.	Other
هههه مشكله العنصريه	Hijazi
احد متهاوش مع احد ويبي فزعه حياتي هالايام خاليه من الاكشن	Other
انا مش بتاع علاقات اذا صار شيء من صحباتي انا غير مسوؤله لن مو مخلين حد م شبكوني فيه	Other
الله عطييييييف كان بدري مو الان	Hijazi
#جلال_40k اكثر انسان مظلوووم فلورزياً مثقف وذكي كروياً ارائه جمممميله بالمختصر ,مهما كان ميولكك لايفوتك المهندس جلال	Other
الله ياخذ القدرات والتحصيلي	Other
بعرق جبيني وتعبي ذولا بارده مبرده	Other
وانت الصاتس ام كلثومهم	Other
ابد مو اخواني URL …	Other
"\" USER : ‏اذا قعدت ادور على شي ما القاه تجي امي بقدرت القادر تلقاه سريع سريع \""	Other
اسمعي شيكي واتس سريع	Other
مع الانفولو الي سويتيه نقص عاد	Other
كنت بكتب لك بس حصلت إعلان وانشغلت فيه URL	Other
أنا من قبل أعرفك كان لي خلان أوفاهم غدربي فوق غدره خان	Hijazi
درجات زق ونفسيه زق وككل ابو حاجه ززق وجعموص بعد	Other
خلو عينكم على اول وحده URL	Other
ويوفقك يالغالي وتستاهل الطيب	Other
بتفزع لكم الهيئة ما عليك	Other
خلونا مع هاشتاقات دعم وتحفيز لجنودنا وذول متربعين عند امهاتهم يبغون انفتاحيه وشاطرين في الهاشتاقات يووووه ي قلبي مفقوع منهم	Hijazi
#حاول_تكون أنسان وكثر الله خيرك.	Other
قاعد انتظر واحد من اللاعبين يعطيه طراق على علباته والله	Other
مدري ليه احس لعبه ينرفزني مع اني احبه	Other
لآ وجهّوني ع القبلۿ و صلّو بيّ يَ الله عسى وِجهتيَ لآ مِت للجنـۿ	Other
USER اهم شي انك انت ترجمتها	Other
محول على مارت تايلر و ألان سمث ابرك من عصام و عبدالله	Other
USER وانت بخير وسلامه يابو سالم والله يجزاك خيررر ويكتب اجرك	Other
USER الله يجزاك خير	Other
تستاهل رجل متفاني وطموح	Other
هذا يابو مشهور زمن الرويبضه ولا كن نقول الايام دواره يوكل الامر لغير اهله واعتقد ماراح يطول الامر	Hijazi
كنت اكابر النوم لأجل احكي معك واليوم كل ما اشتقتلك رحت نمت.	Other
"رغم رقّـة النساء .. إلا أنّ .. داخل كل أنثى أفغاني صغير يطلع إذا جت تصك باب السيارة \""	Other
USER الى الان لا اعلم بس نحتاج اطراف ومحور	Other
هههههههه الله يهني سعيد بسعيده	Hijazi
صورني وكأني ما أدري :-) URL	Other
صباح الخير والسعادة لعيونك عزة	Other
نبيها في جازان	Other
الحشمه مطلوبه في العمل فخامتكم شد حليك واول وحده المفروض تتطبقه كريمتكم إيفانكا URL …	Other
"\"الناس لازم تستوعب إن لكل شخصية جوانب كثيرة جانب مجنون او لطيف او هادي، تظهر على حسب المكان والزمان مو شرط يكون دائماً نفس الاسلوب بكل يوم.\""	Other
لاتزرع الۆٱقع على خد الٱحلٱم ۆلٱ تبگي عيۆنك على من هجرهٱ ۆلٱ شفت گلٍ نٱم .. استغفر ۆنٱم ٱسٱل عيۆنك ۆش نفعهٱ سهرهٱ”	Other
كيف ازاكر اخر اختبار؟	Hijazi
الله يوفقنا وياتس عادي انا ما اعطل الا اخر يوم والحياة حلوة	Other
ليش يعني نبغى بيان يوضح السبب	Hijazi
عفستو العربي طلعتو لي قرون ١٠ دقايق	Hijazi
كلام صحيح عبود بس الكلام ذا ما لتقيت معه الا مره وحده بس	Other
الحمدلله بس خلاص لحم يمين بالله نقرس	Other
اخر ليلة من ليالي نوفمبر مابي لا رساله ولاشيء ابي درجااااااااات....	Other
#شكراً ع الجرح هذا وقتها؛(	Other
#امال_ماهر والله وضعه مزري	Other
انا لما اذاكر انتقال حرارة يزبط علي مسمى الحمار الطموح	Other
اي نوع من المساعده تبغي	Hijazi
عطيناه الديد مانفع	Other
زين انه فقد الشعور	Other
حمود سلطان بحريني سيفي خليجي الرجال حسن نيه وعفوي	Other
ماعليك زود ي صديقي	Other
ايوه تقولي كيف توامبا معك	Other
الفارج الله اتركه	Hijazi
USER لا تروحين انقلعي معاها بس مين ووين	Other
هههههههههههههههه ها كيف التايتن ؟؟؟ بالله مو قوة	Hijazi
USER USER USER اهم شي رقعوا السالفه	Other
USER كل سنه و انت طيب	Other
الف الف مبروك عقبال المراتب العليا ان شاءالله	Other
دايم كذا الفقراويين يحشرون خشمهم بكل شي هههههههههههههههههههههههههههههههههههههههههههههههههههههههههههههه	Other
الله من شيٍ نبيّـه ولا تهيا .	Other
من اول ما دريت ان الوايت موكا فيه كريمة طبخ وانا حايمة كبدي منه	Hijazi
ذحين مين ينقذ الاتحاد	Other
USER USER ههههههههههههههههاااي ما اعجبني الا راعي الطاقيه	Other
USER كبيييييير ي مدير	Other
تراها جلدك روح نام قبل بعد تسري عليك هذي اتحاديه مسكته الخصوم	Other
جارك الله من العبث يا ظويفر وين بتغدي بهم كلهم	Other
اممممين ويشفي نوافي	Other
شكله شال يده لان فيها قرض عقاري	Hijazi
محمد ودك نوثق حسابك على تويتر	Other
و يعدين تجلسون تلعبون سماش !!	Other
مممممستحيل كيف كذا الدراسه عن بعد الموقع الجامعي مايفتح الا بنت اقول استهدو بالله #النت_المفتوح_مطلب_شعبي URL	Other
تسلم ياغالي وربي يجزاك خير،العقبى لك وأولادك	Other
لو البعد سهل ؟ ماكان بكت نوال وهي تقول كل الحكايه اشتقت لك .	Hijazi
شاعرك لا متى عقب صدك يعاني! لاجل عينك ولاجلك يصنع المستحييل مابقى في ايدينه غير نظم المعاني فك له باب قلبك ، ماخبرتك بخيييل	Other
حتى فلوسي الخياليه ما تهنيت فيها ! #تعليق_لعبه_لودو_ستار	Other
تسلملي اخوي الغالي ربي يحفظك وشكرا لك على مشاعرك الصادقة وعقبالك الأفراح.	Other
اوووووووووه الحمدلله عدت على خير وكسبنا 3 نقاط	Other
ﺣﺴﺎب ﻟﺘﺤﺴﻴﻦ ﺍﻟﻠﻐﻪ ﺍﻹﻧﺠﻠﻴﺰﻳﻪ ﺑﻄﺮﻕ ﺳﻬﻠﻪ ﻭ ﻣﺘﻨﻮعة يقدم ﺧﺪﻣﺎﺕ ﻣﺠﺎﻧﻴﻪ ﻟﻄﻼﺏ ﺍﺫﺍ ﻣﻤﻜﻦ ﺭﻳﺘﻮﻳﺖ ﻟﺘﻌﻢ ﺍﻟﻔﺎﺋﺪﺓ ﺷﻜﺮآ ↬↬ USER ↫↫	Other
الحمدلله حلمي اني اصير طيار ، وتحقق وصرت بياع	Other
كأنه جد هايدي والله URL	Other
أفضع يوم بأبريل .. أحبهم والله	Other
كيوتتتتت توني ادري عنهم	Other
عالم فاضيه ولقو لهم سالفه احد يأيد المرأة واحد يلوم الرجال واحد متعاطف مع المرأه ووووو رايكم ذا ضعوة في ماني قايل فيه نيابه وتحقيق ومحكمه خلص القرقر	Other
‏‏فهمتني غلط وقعدت ابرر لك ؟ صدقني احبك ولا كان قلت فكه .	Hijazi
كلهم عاجبهم الموضوع بكل اختصار	Other
: أموت لا من قال: (فدوة عيونه) ويموت لا من قلت: ياهيه بأموت الصوت يذبح والمشاعر / حنونه ( لبيه لعيونه ولبيه للصوت )	Other
جن الهوى ورماني طيرني انا وياك قلبك بعدو بيهواني وقلبي بعدو بيهواك.	Other
تخطي علي اعاقبك كل ماخطيت مصدق ان لك عندي تسعين زله (:	Other
ابشرك بخير دامي اشوفك انتي وجه الخير ع المجلس	Other
USER USER كذا كويس انسه	Other
صحيح ونفس انطلاقاته ونفس مستواه ماتغير ونفس وزنه مشكله اذا تبي تقنع واحد يشبح URL	Other
ومبرووووك لناشئين #الطائي فوزهم خارج الديار على الرائد.. كفوووو ينطح كفووو..	Other
انا.قدمت عام26 لو بنيت من عام 26 كان خلصت من زمان	Other
USER حبيبي بوحميد ،، مانقدر ع العالمي ،، عشق الطفولة	Other
لا صد عنك من توده وجفاك خله وجازه بالجفا مثل صده خلك عزيز آلنفس والعز مآواك وكلن عطه تفصيل ثوبه بقده	Hijazi
سئ روزة معلش يا غالي طالبة ضحك هيا	Hijazi
ماكل العجين موجعه بطنه	Other
حميد طولك ١٦٥ يعني صورتك ببطاقة الاحوال طالع جسمك كامل ولا راسك بس	Other
انفولو كبر ديدك يا صاحبي (: .	Other
#نجلاء_عبدالعزيز انا م اتابعها بس اسمع عنها ولمن شفت سناباتها والله حزنت عليها صوتها حزين مرا وهيا انسانه قوية وتستاهل الافضل	Hijazi
ف النهايه بيلقم الغبي	Hijazi
"يارب لحظات حلوه مثل اللي خلّت فهد المساعد يقول\"أحسب أيام العمر راحت عليّ،مادريت ان اجمله فيمّا تبقى\"."	Other
كلهم ماينفعون لنصر شوف مدرب حقق بطولات	Hijazi
نظاموه عشان يتعاقدون معوه الرائد	Other
اعلمك بشي حدث العاقل بما يعقل انا لو اطلع الساعه ٢ الفجر واصيح بصوتي مرتين ولا ثلاث اتوقع بيتنا والبيوت الي جنبنا شهرين وهم في كوابيس	Other
احسني زعلانه زعل كبير اكبر من قلبي حتى ياخي.	Other
أمكن الهياط حق أصحابنا حوش به. احسن الظن	Other
والله ياما اعطينا ولأقرب الناس وما شفنا شي مجرد كلام ومافي أي فعل ؛ عشان كذا قررت قد ما اخذ قد ما اعطي بالحرف وبالملي بعد .	Hijazi
انتي اسمعي سوالفي ماطلبت رايش في وجهي	Other
ايوه لانك حلوه	Other
"\" USER : تدري وش أقسى كلمة تمرّ بـ شفاك ؟ لامر بك غالي . . وناديت ☽يآحيف☾ ! \""	Other
كل العاب روك ستاز كيذا ما عدى LA Noir يوم نزلة اول مره كانت حمله اعلانية ضخمه كلها تتكلم عن تعابير الوجه المستخدمة وكيف انها تحاكي الواقع، اما RDR ٢٠١٠ و GTAV ٢٠١٣ كان التيزرز وتريلر الإطلاق فقط ،	Other
احلوت مره بعد الطلاق	Other
مفعله كل التنبيهات باطل وارسل الحمدالله وبي	Other
هي تهووون العين ولا ماتهون؟	Other
USER USER طيب ليه ماحققها فريقك	Other
USER ممكن اعرف وين يتوفر كتاب هذا URL	Hijazi
USER زي لما اشوفك.	Other
#النصر_بونيودكور بونيدكور طول تاريخه ما تعادل ولا فاز بالرياض لكن وضيع العاصمة فضحنا	Other
المشكلة تعاملهم بغيض كأن حد موصيهم وبالأخص القبول والتسجيل	Other
راح تموتوا بالعافية	Hijazi
صدمني الوضع !! ابي اعرف محتويات مخك	Other
ابداً ما القى زيك ف حياتي	Other
وربيييي الخير بوجهك	Other
مباراة غريبة ما كانت مكتوبة لنا ببساطة ما اقدر ألوم كونتي على الخسارة.. فوق غياب موراتا وسيسك اصيب ويليان وسط المباراة + اهداف ارسنال الكوميدية... البطولة تبيهم هاردلك للجميع عمومًا	Other
النوم احسن شي بالحياه ((:	Other
ماشاءالله الله يجعلها قرة عينك	Hijazi
متخفيش دنى عط عيني عليك	Other
والله العظيم ناشبه لي كيف افهمها بطريقة إن مالي خلق	Other
ارجعي لفكرك الوهااابي افضل ... شكلك قلبتي علماانية USER	Hijazi
أخلق معي حديثا لأني مش طايقه حدا غيرك.	Other
من قوة السعادة طار النوم ،	Other
طعمه بفمي يالله اشتهيته	Other
كنت فأمان الله اتابع مسلسل وناسية حتى ان عندي دوام وجاني الهام فأخر لحظة اني افتح الواتس والحمدلله فتحته جاتني مداهمة باصيه صرت كذا: URL	Hijazi
تراه يصلي ما يسوق طيارة يعني ماجبر احد وبعدين وين يهرب	Other
الحمدلله ماني بهلالي	Other
USER دام كحيلان على الارض موجود كل الفرق لازم تحسب حسابه	Other
الي عنده خلطه تكبر الوجه يعلمني،لان مو حاله والله انا اكبر وجهي يصغر شفيه؟ URL	Other
بتابعهم وان شاء الله نفوز	Other
محارمنا لاحد يشوفها ي بنت URL	Other
شنو احسن شركة وما تطول	Other
يسعد مساك بليغ واديب محنك تحياتي	Other
#شغله_تضايقك_بتويتر سابقا تبي ينلحس مخك! حاليا المقويات الجنسية!	Hijazi
والله إنّي معها احط الدنيا ورا ظهري.	Other
USER صح كلامك ولاتنسانا من دعواتك يا استاذ وليد	Other
شفت كيف الصدف	Other
اليوم الي افصخ فيه عبايتي بالجامعه هو اليوم الي أكون مبسوطه اني مداومه	Other
تركي الدب دخل غرفة الملالبس حقت الهلال	Other
غريبة حب بعض الناس سرق نومي من عيوني	Hijazi
نوف الله يسعدك احتاج استشيرك في موضوع يخص التصميم الداخلي ، افتحي الخاص اذا ممكن او اقترحي علي اي تطبيق يناسبك	Other
لا والله... تصوير عن بعد حرام بالله ما ثارت البندق عليهن	Hijazi
USER مو مشكلة بحاول أدور الكتاب وأقراه لكن تذكر نهائى كأس العالم للأندية كيف الفريق المغربي تعب البايرن من فريق هاوي وأرجع للمباراة	Hijazi
الله ياخذكم أمهات URL …	Other
ما اعرف بس دلع	Other
تويتر مثل الصاله في البيت اذا جات مشكله تجمعنا فيه #الواتساب_معلق	Other
عطيتك قدرك الزايد لقيتك ما تشيل الزود يا رخيص الكسب كل اللي بغاك طالك	Other
USER ايه جميله وروعه وناسه بدون فلوس ههههههههههه	Other
اهلآ اهلآ بزعيم نجد أشتقنا كثير فـ أهلا بگ #الهلال_القيصومه	Other
يعمرييي انا ياارب اشوف اللطافه دي بس	Hijazi
منت فايز لو تغرد الف مره	Hijazi
فيه منهن للبيع كميات	Hijazi
الله يوفقك ويسعدك وين ماكنتي	Other
والله هذي صباحات امي الحلوه بس منقصه ربع القيمه يقال لك ادفعها انا. URL	Other
استغفرالله !!! تحط صورة لاعب كافر وتدعي للقدس؟	Other
الدراسة تبدأ بكرة الأحد أو الأحد اللي بعده؟	Other
ياكثرك على بالي وياقل وصلك	Other
الله لا يجيب الزعل بينا	Other
خليني اتخرج واكون معك شريك	Other
ترى تحصلهم كلهم في برنامج سواعد الاخاء	Hijazi
لوهله أحس تقصيري لنفسي تعدا المعقول والذكريات السيئه مليانه بمحيطي.	Other
سؤالي لوزارة العمل إذا كان في أقامه الوافد ساق شاحنه ويشتغل مدير هل هذا خطأ وين الامانه عند المفتشين حق وزارة العمل USER #تجمع_العاطلين_السعوديين67	Other
على بآلي ولا انت دآري♩. #نجران_الان	Other
فتح عنيه بعد ما كانت مغمضه وقد اي كان ظالم نفسه ف كل دا ..	Other
وذا برضوه اتوقع نفس الريحه بينكم مشتركه يالضربان	Other
دايم نختمها بخمسسسه هههههههههههههههههههههههههههههههههههههههههههههههههههههههههههههههههههه	Other
USER تاج راسك كلامنا	Hijazi
منب ناطله انا بسس بششوف شكلتس تناسبين اطبخ عندتس او لا	Other
ييي افضضضللل فنااان كللل قلوب الدنيا له والله	Other
ياعمي اللي هو	Other
الله يجمل حالك وحالنا	Other
ي محمددد واحد كبده ع الصاج '	Hijazi
ي قلبي ي معاذ.	Other
الليله مهب وبرررد : URL	Other
وانا خلوني اغني الاوست URL …	Other
لا وين ذي تغريده عن مباراه المنتخب الامريكي للسيدات.	Other
بالوضع هذا تحتاجون معلم صعوبات التعلم الى متى هالتخصص شبه مهمّش بالتعليم مع انه مهم جدا USER USER	Other
ماشالله ، طيب وش وضع نجمة داوود	Other
USER الله يعينكم حنا اليوم جونا ممتاز الشمس طالعه URL	Other
والله ييسر أول ميد ويعديه على خير	Other
المهم انا دحين اوفيشالي عمية .. كارهتكم كلكم ، الله لا يذوق مسلم احساس العمى .	Hijazi
والله زمااان يا سيد آسياا الفف مبروكك فوز يبررد القلب #السعودية_العراق	Other
اييههه وشفت دخانه الله يحفظنا ويرد كيدهم في نحورهم	Other
USER USER الله ستر، وانصحك بتغير نفس الفيش الى ثلاثي او فيه نوع باكستاني افضل من هالصيني	Other
سلااامة قلبك من الآهخ	Other
مثل ماخليتك فوق زيّ النجوم واراهن على نورك اقدر اخليك زي شهاب مرّ ولا لمحته	Other
"أغليك والدنيا حظوظ وتوافيق يالي غلاك بخافقي انفرض فرض ودعتك الله عن عيون المخاليق لأنك ملاك يعيش في كوكب الارض\"\""	Hijazi
وانت بخير حبيبي	Other
المشكله اني مطلعك من كاس الملك واخذ الصداره منك وبعد مافزعلكم التعاون خليتك مسيار نفس جارك يبقى العميد هو الكيان القوي بالكوره السعوديه URL	Other
راكبين مع العفش ولله الحمد انتوا بوق	Other
انا مستغربه منه USER USER USER	Other
يالله على حسابي ب عشيك تخليني غصب أجوع	Other
ماغيرك اللي شرّع القلب بيديه ولا غيرك اللي شد قلبي وتلّه.	Other
اللي ما يتعدل يتبدل اس تي سي اشوفهم اطلق شيء حالياً بعد رفع سياسه الاستخدام العادل	Other
#توقع_نهايي_كاس_العالم البرازيل*بلجيكا اذا ماتواجهو بدور ٨ ودور الاربعه. واتوقع البطل،البرازيل	Other
#النصر_عالمي_اسيا وواثقين بعد الله يرزقني ثقتكم بس	Other
الحبه من 5 ربال URL	Hijazi
ماش اليوم مالي خلق ادرس	Other
مع بنات خالتي ممكن تاكل أي شئ بأي وقت ، صباحكم اندومي	Other
يراودني شعورالوحده كثير ذي الفتره.	Other
مهو معطيك تذكره	Hijazi
هرد لك نادي الهلال وألف مبروك لنادي القرن الحقيقي الزمالك #كاس_السوبر_السعودي_المصري	Hijazi
الله يجزاهم خير URL …	Other
ابقي الناس اللي يجمّلوا يومنا يارب	Hijazi
ايه وبدون مهر	Other
يستاهل ابو زياد وانت اعلامي مخضرم لن ينساك كل رائدي قديم بيض الله وجهك اخ رشيد	Other
اهلًا سي قمال منور تويتر الزيك والزي الوالد واخواتك	Other
أهل الحب صحيح مساكين .	Hijazi
يا طاقية يا المسخرة	Other
لو دعم الهيئة أُعلن عنه في وقت سابق كان شفنا عموري في المعسكر ولا صارت كل هالبلبلة عدم تجديد عموري تتحمله الأدارة 100٪100	Hijazi
لانك مقتنع انه جي للاسف	Other
هدفين وهذا لعب الهلال تقوله صادز!!!	Other
الرولان لعبة نادال	Hijazi
شباب مين شراء حلواني	Other
احكي لك لما اشوفك	Other
ايوه تقولون وش حيله المشتاق ؟	Other
اراااهن ان لوفي كان يصيد القراصنة عشان اللحم URL	Other
يا زين الدنيا اذا دارت ودارت ثم هفت ملاعين الجدف كفوف.	Other
اول هدف للفراعين وقادرين يجيبو اكثر #مصر_هتشيل_من_غانا_فولو_والباك_معانا	Other
خذه من ابوسند بعيدا عن التفلسف بتنزل ل62 ونص واتمنى تنزل اكثر	Other
“ USER : متظاهرين في القطيف ا URL ا ^ كفوو ياراعي الجمس #رتويت”	Hijazi
#شعوري_هالليله_يقول . . يبتسم لك قلبيّ كل ما مريتي في بالي. URL	Other
مو شرط يجيك بأسلوب مقرف (جربيني)	Other
وهذا الى في تلجرام ما يرد الا بعد ساعات	Other
USER انا الي يرتبط فيني يسعد طول عمرو :)	Hijazi
الله يقومك وانت بصحه وسلامه	Other
أثرت فيني من عطفش قسم بالله يديم الأشخاص اللطيفين URL …	Other
فراقك اه ي فراقك كسر قلبي وعذبني	Other
اقول فصّل قبل م تندم ب ليلة العيد وتطلع الكرشة .	Other
الله عليك يابوهادي	Other
حماسك يجنن بس لاتسوينهن بيوم وتجلسين باقي الايام فاضية	Other
USER ياأخي أذكر الله ..تصدق مابقى دوله بالعالم مازرتها خلاص مليت من السفر	Other
أجمل عيون نايمة بهالوقت،عيونها*.	Other
من وجهي حتعرفو كيف كانت سنتي URL …	Hijazi
#NAME?	Other
خلاص اهم شي فهمت انت ماعليك من الفرق انقلع	Other
يا أني اكون الاهم ولا عسّاني ما اكون.	Other
ويلوموووني ليه احببب بيتروووس	Other
اها تقصد الحالمي هذا خوينا ماخذ اجازه قبل الروضه حتى	Other
اهم ماعلي اميسي يرجع للعمق	Other
شرايكم ياعالميين ضبطتكم بالخلطة اللي هزمتهم #الهلال_فلامنجو	Other
"\" من جاز لك جزّ له ، ومن شان خلّه \" - نمط حياة جيّد."	Other
قلتها زبالين القاره اقنع امك لاتقنعنا بدري ع اصلك هههههههههههههههههههههههههههههه	Other
واليوم ودي أغني للسما حتى أنا يا سما عندي قمر	Other
ي ليل من جد طلعنا نفسيات	Hijazi
اغفل لاتفطن احد عنه راح ادم ولايروح طلال نحتاج خبرته باسيا	Other
لا شكرا ميحتاج يقلبي خليكي فصحباتك اننن يع يع	Hijazi
صراحة بيبي ماتوقعته كذا لكن الولد عجبني اليوم	Other
حسبي الله عليكم من جامعه كل ترم تغلقوني حسبي الله عليكم	Other
USER بالعافية واحشنا والله :)	Hijazi
أللهُم حضّن حبيبي ولّمة إيديه..	Other
#الاهلي_هجر. سداسيه جميييييله ومستوى خورافـي والقاادم اجججمل بأذن الله ، ومبروك ي ملووكك	Other
"اكون لعمرك عمر ثاني بس لا اشوف عيونك حزينه.\""	Other
#NAME?	Other
ودّي ادرس بالكويت أحس انّي بتخرج الاثنين الياي	Other
احمدي ربك قصيت لك اقول	Other
لو أقدر أجيبك عندي وأقعد أتأمل عيونك ؟ يا الله على النعيم اللي بعيّشه وقتها .	Other
طفشان و ودي اروح للبحر مشبب	Other
‏ اختلفنا من يجي للثاني اول , امتلينا ”شوق” والميعاد طوّل #وجهة_نظر	Other
الله ياخذكم من دفاع خريات	Other
ولو بالخدمه حنا	Other
ولا فى غيره يضحكنا اووووه اووووه	Other
فيني تعب لا والله اكثر حالي صعب لا والله اكثر كنتي الحبيبة والصديق واللي خذتني من الطريق وسكنتني اهدابها #رماد_المصابيح #abdu	Other
فيه شي ما تقدرين تقلبينه اغنيه ؟	Other
USER الحمد لله على كل حال بس :)	Other
صادق.. الشركه الكبيره ذي الكادر الوظيفي الضخم انتاجيتها اسرع لا اجود.. فلربما شركه صغيره فيها ٧ موظفين ومديرهم ممكن تنطح السوق	Other
USER USER ﻻزم نسأل ونتعرف على الحياة اﻹجتماعية لﻷماكن التي سنزورها تجنبا للي شفتيه	Other
USER هل يحق ليه ان اطبع شهاده التفوق وعلما انني من خريجي الدفعه التاسعة ..؟	Hijazi
أحلام العصر يابوي	Other
الضب احسه ما يكره	Other
يابن الحلال اسمهم رجال فقراويه مايفهمون تبي حريمهم تفهم	Other
جهزو الكرسي حقي	Other
هههههههههههههههههه سحبان الخالق	Other
نبقى مهور هركي	Hijazi
USER خلص الكلام معاش( ˘̯˘)	Other
الحمدلله سويت كلشي ولا ذاكرت	Other
ياساتر نص #جده مافي كهرباء	Hijazi
الله يبلغك شفها ويحفظها لك واطمنك السرطان حسب معلوماتى علاجه اسهل لصغيره من كبار السن بالتوفيق لها قلبل من الجلسات وبينتهى تعبها ومرضها وتشوفها عروسه باذن الله	Hijazi
شنطة قوتشي هاي كوبي جلد مع سير كتف نظارة قوتشي درجه اولى مع ملحقاتها عطر ميني شكل قوتشي قلتي انتنس25 ملي تي شيرت حريمي السعر 300 ريال	Other
USER USER صحيح طالبه عشان يضحك كل ماشاف التيشيرت	Other
في خيالك مستريح وفي عيونك ساكن لو رحلتي والحزن عاد بشكل تدريجي اقدر اقول ارجعي لي يا عنيده .. لكن اسمي الرنّان ما يسمح ولا برستيجي	Other
ياعمري يا ابراهيم الله يبارك فييك	Other
هاه شرايك بطعم الجحفله ،	Other
يارب احميلي ماما يارب طمن قلبها	Hijazi
ياكل بسكوت مالح	Other
ماي ابوي جعله للجنة URL	Other
شايفه يا ميما فايزين ويصيحون بنفس الوقت URL	Hijazi
• ㅤ ㅤ ليت لحظات الموادع مشاعرها تباع ولــيتها ماهي تِــطرى ولا نِبــلى بهــا ㅤ ㅤ #ليييييت ء	Other
USER لعبة The Wolf Among Us لما تنزل كل الحلقات هل بينزلونها بعدين كامله زي the walking dead ؟	Other
ㅤㅤ يا سيّدي ؟ الحب مو كله فرح ، لا بد من لحظة عتب .. لحظة زعل .. لحظة نوصل للرحيل .. وبلحظة الشوق العظيم نرجع ونبدا من جديد !	Other
•• اعرف اعزاز النفوس.. ! من الرديّه كم وفوني ناس وكم ناس غدروا بي ••	Other
بس أنا اللي في ثانية وحده تنقلب نفسيتي فجأة؟.	Hijazi
تفو عليك ي كلب URL	Other
مثل الشباب تقول اجل انت ماتعرف مين الشباب ، الشباب لايشبه مع احترامي للفرق الاخرى الشباب نادي كبير خارجياً ومحلياً وارقى من غيره	Other
واحد كاتب اتحمل كل شي إلا إني أمسك سرى في المقصف يوم الخميس... مؤلمة حتى البكاء	Hijazi
سبحان الله لاني تعبانه صرت أضعف قدام أي مشروب باااارد اشوفه :)	Other
USER يسلمووو من ذووقك	Other
شكل الدوره نزلت عليها عشان كذا ما دعت	Other
للأسف 2-1 لروسيا مع كل هالحماس و التفائل من الجمهور لكن الله يوفق الاخضر	Other
من بعيد لبعيد ، عيني عليك وقلبي معك .	Other
وشذا ياخي فلامنيغو دافعين رشوه؟	Other
#في_غلا_سبيع_لااسمع_ولا_اطيع كذا اشكالنا وحنا ترند URL	Other
متى على الله نطوي العفش ماشين ، يمّ الديار الي ذبحنا غلاها ~	Other
ماشاءالله على اظافري صراحتا فيها تضامن عجيب ينكسر واحد بعده تتكسر الباقي (:	Hijazi
لا احد يحجز ، اصبرو يومين وتصير مجاناً بالطيب بالغصب الا يبون ٢٠٠ الف شخص #مدل_بيست URL	Other
ياثقل يوم السبت.	Other
شفته. وانا أخالفكم الرأي مع احترامي لكم. اللي حصل ان فلامنجو لعب بطريقة غريبة ومتراجع بطريقة اغرب !!!؟؟؟ لكن يوم صحى ورجع لمستواه الحقيقي هزمكم	Other
"بعض الناس ودك تقول له !! خذ أذنك لقيناها عندنا و حنا نسولف\""	Other
شكلك حق مشاريع	Other
المشاعر الي تنعطي لي ولغيري مب بحاجتها انا!	Other
أصيِر لك فرحُة بس ضحكتِك لاتغيبْ.	Hijazi
بعد يعني في اكثر من كذا	Other
يحبونكك كثري ؟ صدقني يكذبون	Other
اهليييين تكليجه رقم ٢	Other
#تتزوجين_واحد_يلبس_شورت ع الاقل شورت ارحم من يطلع بالشارع بسروال وفنيله وقمصان النوم ترا هنا شكلك غلطط ويلوع الكبد	Hijazi
يا عمريي الله يرحمه ويجعل مثوااه الجنه	Other
ولأنه يحبّك بتسعده أبسط الأشياء منّك، ولأنه يحبّك بتحزنه أبسط الأشياء بعد.	Other
والله إبراء للذمة انا سمعت انه موظف واحد يدير حسابه .. اما ان كان هو نفسه خوينا فياسفا بعمر راح	Other
قمة الامل ان صاحب شركة نوكيا للحين ينزل اجهزة ~ ياخي خلاص استسلم	Hijazi
والله ياختي كلامك #درر	Other
USER قولي ليا انا	Hijazi
هات فولو مع تم اردها بثواني	Other
USER USER شكراً بس ابي الاسود من الحين اقولك وابي بعد ١٢٨ قيقا	Other
طلعوا المعيوف ياحوش	Hijazi
"عبدالمجيد يوم قال: ياعديم الشوق بعدي فيك م اثر\" مايدري ان الشوق خذا من العمر نصه بس نكابر."	Hijazi
أنا وإن قالوا تحبينه؟ أقول شوي! أخاف إنك بعين اللي سأل تحلى.	Other
"\" USER : المخادع ،. قد يقع في شر اعماله لايطوفكم URL \""	Other
وش انشر مافهمت	Other
عشان مؤهلتو وموزونتو	Other
#السعودية_كوريا_الشمالية الشوط الثاني المفروض يحيى الشهري بدل سالم وفهد المولد بدل البلنتاوي	Other
لا لا قدام جهزي بس	Other
طيب وقت الفديو ما حقك منزلاهو ليه؟ دا كلو عشان رتويت؟ ديل شنو المرض ديل URL …	Other
لا خليهم معاك لو احتاجت هكلمك	Hijazi
علقو الدراسه يازقان	Other
كل وانتم بخير يا حبايبي،،لكم وحشة	Hijazi
لا ذا هو الدادي حقي هههههههههههههههههههههههههههههههههه	Other
والله المدام ساره صريحه	Other
USER اضحكي بس لاتفضحيننا	Other
#لو_صار_تويتر_حكومي الشباب يشتكون ان الدخول بتويتر لازم عوائل	Other
المرايه يوم من الأيام بتقول لأمي ترا بنتك مجنونه .	Hijazi
بعض المحاضرات الشيء الوحيد اللي اتعلمه منه هو الصبر..	Other
اههّ يازين تبوك وهي مطر.	Other
والله كثيرة ٣ساعات ههههههههههههههههههههههههههه	Other
العقلانية عندي طاغية، أنا فعلاً أقدر أحط قلبي على جنب وأقرر	Other
اي والله شاكه بالموضوع صاير الطريق زحمه يضيق الصدر	Other
ياليت فيه مناكير اول ما اصلي يختفي واذا خلصت يرجع من جديد.	Hijazi
ومسوي لهم تنبيه بعد واحيان يحلم فيهم ويفز من النوم	Other
فكرة اني اكون الطرف الصبور اللي يتحمل ويعدي الغلطات ما تناسبني ابداً.	Other
هانت باقي يومين	Other
ياربي والله انك صحبة العمر مو بس الابتدائي، احبك	Hijazi
احلى اغنية لأحلام و ما اعرف كيف غنتها. وش ذكرك!! كان فيها احساس جبار. بس الان اتحولت بسم الله. #احلام	Hijazi
بكل سهولة كذا يهون عليك فراقي؟ URL	Other
احياناً ضروري نخبي شعور معين لأنه لازم ينعدم ، لازم يموت ولايبقى له أثر .	Other
USER هذولي معلقين بطولات الحواري في جدة	Hijazi
الله يصلحه تنرفز على فاول بنص الملعب لو بلنتي اشوى	Other
ولا يوم يقدر ينافس غثاثة يوم الأحد	Other
مسيتي بالرضا يمكن شقيقه خلي احد يطقها لك مع الشعر	Other
تبي تعلم انه تخصصه حاسب بس ماتدري شلون URL …	Other
حلوه حلوه هههههههههههههههههههههههههههههههههههههههههههههههههههههههههههههههههههههههههههههههههههههههههههههههههههههههههههههههههههههههههههههه	Other
مافيه حل معهم للاسف فالحين يستعرضون بفروعهم الكثيره وبدون فايده	Other
USER الله يعافي ويشافي أمك الغالية والله يلقاكم ودرب السلامه طريقكم ما أعيش ببلاد ولاهي بأرضها USER أبي عيوني كان ما هي قبالها	Other
الليّلة هذي واضحة ليلة فراق حاولت أعديها وعيت تعدي .	Other
يستاهل الحزم وعقبال مراكز متقدمه	Hijazi
من زين فرتي علشان اطلع بدون عبايه يدي ابيض من وجهي #من_حقك_تطلعين_بدون_عبايه URL	Other
العويس المنفوخ من الهدف الاول عرفت انه مو مشتهي يحرس #الأهلي_الحزم	Other
الله يبارك فيك ويجزاك خير	Other
لايضر السحاب نباح الكلاب ادعس على خشيمهم والقلب داعيلك	Other
عوده حميدة دحووم وبعض الروافض خلهم يموتون بحرتهم جعل جهنم تشويهم	Hijazi
اوكي اببغى وظيفه وكذا بس نفسي قبل الوظيفه ارتاح	Other
وضعنا يضحك حالة تقشف مو طبيعيه	Other
في آخر سنة لي في الثانوية شطحت وهربت من المذاكرة واللحين آخر سنة لي في الجامعة وعلى نفس الموال ونفس الهربه	Other
الله يرفع قدرك يابوفيصل ويمد بعمرك	Other
USER وجه ويد هه	Other
بتعلم عود وبتتمنون وقتها ..........	Other
حبيت كل مافيك وحولك ولين اليوم مالقيت فيك اي عيب انت كامل ولا من حبي لك انعميت!	Hijazi
مهو قال الله على الظالم مايقول العبد على الظالم	Other
سلام عليكم اقدر انزل الجلبريك الصيني عن طريق الايفون نفسه؟	Hijazi
#منسدح_لا_تكلمني اللهم يا مقلب القلوب أقلب المواعين على العيال.	Other
حفل الهلال حلو مره الاعلام تذكرت حفلات glastonbury	Other
USER عبدالله العنزي يالغالي..	Other
كرف كرف للمعلم حتى انهار امام توصيل المعلومة لطالب اضاعوا الهدف الأساسي	Other
حشا انا القاسيه يوم اني جمعتكم تتهاوشون	Hijazi
USER الله يجزاك خيرر	Other
يارب افوز معك ياسرع لمره واحد بس	Other
جات له عروض بس للاسف خسرتوا اللاعب والكاش	Other
USER تكمل ان شاء الله فرحتنا ، جايين من المدينه بإذن الله	Hijazi
ياهوووو التفت سلم عطونا وجة ...	Hijazi
تستاهلون الترند وبجداره URL	Hijazi
أرحببببببببببببببببببببي نورتي الحته واللهي	Other
انا تعليقي ع نقطه لو فيه توعيه كان مافيه مصابين فقط.	Other
وي حي وجهتس .	Other
USER USER تم للكل الفلو باك شباب انتظار ٢٤ ساعه= انفلو	Other
منتظر صلاة العصر تخلص	Other
"عندي صديقه جدا جدا عظيمه وحبها بقلبي اعظم\"مومعقوله هالانسانه."	Other
ايه، أرسل لي مقطع (ماركا) بنزيما و شوستاكوفيتش ما حصَّلته ابدًا	Hijazi
بيض الله وجهك ي كبتن سامي ماقصرت واتمنا لك التوفيق	Other
"يسموني \" بنت ابوها اللي مايدرها \" ."	Other
اسلوبك اجل يالله صباح خير	Hijazi
هههههههه الله يسعدك ولا اوصيك ب غيرها ب الي يستاهل ومافيه غيرهم وتدري انت انهم سبب الي صاير رئيس الغفلة والسباك هم ساس البلى ..	Other
ياحـي صـوتٍ لاسمعتهِ تهنيـت	Other
USER USER عارفه انك ماتكذبين بس هو مراح ينكسر ! وبتشوفين	Other
كل هذا اللي تشوفه من سنيني ومن حنيني طيبتي كانت عيوبي كنت طيب ما فهمت	Hijazi
عنده غلطه وحده وصلحها بنفسه	Other
يصإاحبي ععإامن مضى ؤוبتداء ععإم ؤانإ וنتضر ففي كل يؤمن تجينيٌ ' ' منور يإالعام ﺎلجديد ، ١٤٣٦	Other
ماافيه حل صدقيني وان لقيتي قوليلي الله يسعدك تعبت منها حقيقي	Hijazi
انا ما أصدق هذا المقطع ابيت والارضيت	Hijazi
ما قال الا الصدق صراحة	Other
USER وش ثنوي يرحم امك لا انا جامعة	Other
جو الاختبارات يطفش بشكل.	Other
USER ياللي تنافسنا ترا توّك صْغير وزعيم نصف الارض : منته بـ قدّه خل الهياط ولا تدوّر معاذير الدوري و جبناه من قلب جده	Other
"عادي توصلوني 900 اليوم ؟ .\""	Other
عمممري مرااا احبك	Hijazi
على خبرك يمل الغروب من هذا الفضا وينام،وانا ما امّل وانتظرك .	Other
انت وسخ كبير	Other
- حتى وآنآ آحكي معكك ؛ م آشبعكك آشتآق لكك وآلحل معكك !	Other
متى توب من كسر الخواطر ؟ انا البحار وانت ظهر السغينه ~	Other
اذا كرهت احد لا يمكن ترجع تحبه	Other
دام تاكد غياب سيلفا اتمنى نشوفه في الوسط مره ثانية URL	Other
ي كبر ذنبك ، لو تحسبني نسيتك .	Other
هذا جزاهم عشان تتابعها وانا منسدح بفراشك	Other
USER USER USER سعد عيني بعينك؟	Other
الحكم ليش ما يعطي كروت للاعبين الهلال؟؟؟؟؟؟	Hijazi
الابكم اذا جا يذاكر يأشر ؟ و لا بس يجلس يذاكر وهو ساكت حمدلله على النعمه	Other
ينتفخ قولون وتحسّ إن بطنك حاويـة مشاعر.	Hijazi
USER USER USER USER USER USER اليوم تجمعنا بعد الدوام نبي نحدد الموقع للقاء جميعا	Other
نونو الإعلام يمسي عليكم URL	Other
هههههههههههههههههههههههههههههههههههههههههههههههههههههه هههههههههههههههههههههههههههههههههههههههههههههههههههههه هههههههههههههههههههههههههههههههههههههههههههههههههههههه بس الشرح بعص السالفه	Other
اكتشفت ان نصف اللى بتويتر يلعبوا بوبج	Hijazi
طيب انا طلعت من اسياء انتي كم معاك اسياء يا طحلبيه	Other
من زين شنبك	Other
USER يعني انتي مستعدة ؟	Hijazi
ابوناصر ارسله اكسنت هذا مايفرق بين الدوري الانجليزي والاسباني URL	Other
وإن غبت عني عسى ماني لأحد غيرك.. وإن غابوا الناس أنت الناس بعيوني	Other
نام على جنبك اليمين واقراء اية الكرسي	Hijazi
افا هذي اخرتها	Other
تستغرب من الاصرار على ناتشو ظهير وهو اساسا قلب !! وريغليون اداءه وعرضياته ممتازه ليه مايلعب !!!	Other
يعافيك ايه اعشقها هالوققققت	Other
والله انتي المزيونه	Hijazi
اذا تبي اللعب بالعقل والمهارة رونالدينهو	Other
أحتاج إعادة تأهيل للتعايش مع الترم الثاني بصبر طويل ونفسية حلوة،اما الوضع كذا كارثة.	Other
ياأحلى وأجمل من انولد فيه	Other
اي حساب يحط اسئله راح ابلكه وافتك	Other
قووول للملكي .. عطوه الدوري عطوه	Other
USER السلام عليكم انا معي مفوتر ٣ وسددت ثالث فاتوره ولا استحقيت جهاز متى راح استحق الجهاز فضلاً	Hijazi
اححح ، خنقتني العبره URL …	Other
والله ي انت مغبون من النصر وأنك مقهور مستحيل تغرد الا وتجيب طاري النصر بس مادرينا عنك لانك امعه ناقص عقل بوق مدفوع الأجر ضعيف شخصيه تشعر بالنقص فيك وفِي فريقك ولا تستطيع المواجهه لا انت ولا فريقك بس زيد صيييييييياح ياشاطر.	Other
المطر هو اكتر شي قادر يتحكم ف نفسيتي .	Hijazi
ماني مكدر خاطري عليه في الويكند	Other
عندك البن الشرقي بالحمراء او جاردن لاونج مخرج ١٥	Other
تحب اللي يلبس طاقيه انت شكلك؟	Other
مايهمني اهتمامك وقت الرضا اللي يهمني اهتمامك وقت الزعل	Other
ٳبتسامتك وسعادتك على فرحة غيرك وكأنك أنت اللي مبسوط ! هذي بحدّ ذاتها نقاء الله يقرّبنا من الأشخاص اللي سعادتهم من سعادتنا .	Other
كل شي صار اليه الا اليوم الا حاجه	Other
مدري عنها شكلها معصبة من الاختبارات	Hijazi
لو مستغفر فيهم أبرك .	Other
هو ماسرقك! طلب مبلغ علشان يرجعه لك ( حق المشوار ) ومن ابسط حقوقه الرجال يكد اذا بيجيبه تكرماً منه او يطلب حق المشوار ، بالنهايه ماهو خطاه بيوقف شغله ويمسك خط بلاش؟؟ الا اذا طلب مبلغ كبير وقتها يعتبر انه طماع فقط.	Other
بعدين عاده مملوك للبلديه	Other
لا صار حضورك بلا معني يصبح غيابك افضل للكرامه من يودك و بغاك جا وتعنى ومن عافك دور لك عذاريب وملامه	Hijazi
#برنامج_مللي86 ترى عمر كان يطبخ يوم كامل وبالاخير مايطلع معه اكله يعني الشباب الي جوعانين لاتعتمدون على اكلتهم اطلعوا دوروا لكم اكل	Other
مدري بس احسك كأنك تقصدني	Hijazi
USER USER ههههههههههههههههههههههههههههههههههههههههههههههههههههههههههههههههههههههههههههههههههههههههههه اننننتتتي رهيبه	Other
#حايل_الان واللي جعل شمر يحبون حايل إنك بقلبي تسنك جبال سلمى URL	Other
عطوني رابط حجز التذاكر بليز	Other
انا لو نسيت الود ما انسى إنك خذلتيني .	Hijazi
طبيعي طبيعي، الله يديم روقانك	Other
اعطيك حسابي أرامكس شدخل بيتنا	Other
شعور ان خلص العرس وطلعنا فاصخين الكعب ونمشي حافي.	Other
لا تحطوا فيديوات كذا حرام والله نتعب	Other
علميني به وادرس الوضع	Other
مافيه مجامله ابداً	Other
الطقمم ذا لازم نعتمدههه لنهاية الموسم	Hijazi
من حق الرجال المطالبه زي النساء ومن حقهم الزواج من الخارج ونا مؤيد جدا	Other
USER وانا اقول أكثر الناس لما اقابلهم هق مي هق ولا يفكوني ؛) .. قسم ما أعيدها	Other
USER انتي تنحطين بالمتحف مؤقتاً ماندري بكرا وش يصير	Hijazi
USER USER صباح الخير عالجميع ، اجاااااااازة بس لازم أصحى بدري	Hijazi
بحب اتفرج ع الابواب والشبابيك URL …	Hijazi
عندنا بالسعودية عجوز خمس سنين بعدها ماعاد تنجب	Other
كل حاجة معدتش ليها لازمة نفس ايام زمان ترجع تانى URL …	Other
اليوم المفروض شبكة اخت صحبة اختي وامس ابوها اتوفى الله يصبرها ويجبرها ويربط على قلبها ويصبر اهله، اللهم… — URL	Hijazi
كذا احسن مكافحة الفساد يبغلها رقابه من اول . أنا تضررةونفصل بسبب بلاغ عن فساد ولا نفعنى مكافحة الفساد كل يوم تصرفنى	Other
لا مو مكتوب	Other
"\"أنا وقلبي\" محتاجين أيام حلوه .."	Other
اشتري لك ولا اذ شفتيها بالشارع نظفيها وخليها معك	Other
عاجبك يعني الاماكن هذة لازم الجهات المعنيه تقفلها ... ولا والدور جاي على محارمكم	Other
يستاهل المهندس / نشاط التكريم والله يوفقه دائماً ..	Other
USER وش رايك تحط صورتك مع الزعتر في التويتر ثابتة أشوفها احلى ماشاء الله	Hijazi
USER متععة الله ياخذ القرديس	Other
هههه حلوة.... الف مبروك لنا جميعا	Hijazi
بالعفو لطوال المراقي رقيت بالعفو حاز القلب كل السرور الحقد ياأهل الحقد ماجاب صيت شر القلوب اللي بحقده تفور URL	Other
دُرر يا بو حسان	Other
أنت تستغني عني,وانا اعتبرك م انخلقت.”	Other
هههههههههههههههههههههههههههه انقلعي ذاكري	Hijazi
ياهي رهيبة اللعبة بس وجهها يفجع وهي تقلب في ملامحها تقول داقه في الحبوب دق	Other
الدورات اجل يارجال خذها بصريح العباره انت رجال غشيم متعافي والكل ما يوقف عند سيارتك لان خابرك على فالك .	Other
وسبعين نعم يابو يوسف بك وبخال عيالك، ألف مبروك تخرجه ونتمنى لكم التوفيق والسداد في قادم الأيام بمشيئة الله	Other
خلصت خل احد يقول مايضحك	Other
نضحك ونخفي ورى ضحكاتنا اشياء ما ودنا الناس تدري عن مواجعنا	Other
أشغلـتهم .. هـذا و أنـا ما تكـلـفـت وشلون أجل لو جبت حرفي من أقصاه واجب عليّ أشوف نفسي إذا شفت الفاشل اللي يقول للفاشل : ااااااااالله	Other
( جيتك ) وآنا خابرك دايم على ظني .....مكـآني القلـب .. لآ فـوقـه ولآ تحتـه عقب آلزعـل لآ أنشدوك الـعـرب عني ......قوول أنه أخطآ وراضآني وسآمحته	Other
USER الفكرة تجنن سويها قبل ما تولدين.	Other
خلوكم في نادي الاتحاد اما الامور الكبيرة فهي تترفع عنكم!!!!!!!	Other
هذا بس مدري مين URL	Hijazi
كفو وفالنا الفوز	Other
سمعني ........ بطل الشتاء الاحتفال ليسى بسبب الصداره الاحتفال بدق الخشوم للمهنا ولجنه الحكام التي تبي الصدره للمحلي	Other
امم شكلي بحمل حراج	Other
لاتنتقدون محمد بن فيصل وتغفلون عن البليهي من بداية الموسم وكل نكبة بدفاع الهلال وتقريبًا اغلب الاهداف اللي علينا سببها البليهي #الهلال_التعاون	Other
أنا لحبيبي وحبيبي إلي ياعصفوره بيضاء لا بقى تسألي لايعتب حدا ولا يزعل حدا	Other
يقولون درجه الحراره توصل عندكم ٤٠ صحيح الكلام ؟! URL	Hijazi
غنتها ريانا بس اللي كتبها سيا	Hijazi
USER USER فيك الكبريت وانا الطراطيع	Other
لحول ياذا اللعبه!	Other
السالفه فيها فويزات برسلها لك	Other
* -تصحى بدري للدوام -صباح الخير -فنجان قهوه ملاحظة جمال اللحظات البسيطة ينشئ اختلاف كبير بحياتك .. ~ ويا صباح الجمال ••	Other
آه يا ساعه الشقا الناسات نايمين وانا من قاعه للثانيه	Other
وش مهمة طبيب ومدرب وإدارة الفريق!!!	Other
دخيل المشاعر لا تخلّي النوايَا: حْيام على عد هقوات الجفا.. لا تخلّيها عليك الحنايَا مِشْفيَة والحظوظ صيام عسى الله يزيّنها على حظ راعيها !	Other
الله يحفظها اكثر سعادة للانثى مهما بلغت لمة محارمها اولاد وزوج واخوان تحسها قوية بهم وهم قويين بها	Other
USER اي وحده توها محوله تخصص قانون تنط خاص .	Other
شاركونا : اسمك حقيقي :وعد مكان ميلادك :تبوك لونك المفضل :اسود كم طولك :١٦٣ لاعبك المفضل :محد متحمس للعيد :مره فيه احد مشتاق له :مشتاقه لنفسي اخر هديه :نظارة كم في رصيدك :معرف URL …	Other
جندي ياباني ضل مختبئاً لمدة ٢٩ سنة.بعد انتهاءالحرب العالمية الثانية وذلك.بسبب أنه لم يخبره أحد أن الحرب انتهت ^هذي الزبنهه عَ اصولها ̷	Other
USER إلى الله المشتكا مابيدنا شي	Other
الكلمه تصيح بالزاويه هههههههههههههههههههههههههههههههههههههههههههههههههه	Hijazi
كلب ذا ماهو مفتي	Other
عن كمية الحنية بـ نظراته قال عبادي العذاب اللي بعيُونك يعلم الناس الشعر .	Other
اطرافك ي ربي	Hijazi
نقول يا رب مع ان التفاؤل عندي تحت الصفر ما هو بس صفر	Other
USER السلام عليكم ممكن ع الخاص لو تكرمت	Other
": أغبى موقف !!؟ لما تودع شخص وتقول : ياللہ مع السلامہ ، وتمشون في نفس الاتجاهـ ، ماتدري تسولف معاه ، ولا تسوي نفسك ماتعرفه !\" هههههه"	Other
يارب حاجه حلوه تجي من اللاشيء ، فجأة تكسر الروتين وتبسطني الى مالا نهاية.	Other
USER لا انشاءالله الرجال يسوها	Hijazi
اف ياربي قلوب من هنا لبيتهم URL	Other
الهلالي كان زعلان على خروج عمر هوساوي النصراوي قلبه مع العابد، الأهلاوي يطالب بفهد، الاتحادي يشيد بتيسير #السعوديه_استراليا #السعوديه_لعبتنا	Other
اذا احد قال لك انت ذئب امعط URL	Other
نفس احلق شعري صلعة وأبدل جلدي كله من الى مثل الثعبان ويصير جلد جديد . +٢ م استهبل ..	Other
#كذبه_كنت_مصدقها_وانت_صغير اقول لابوي اشتر جيب يقولي تبينا نثقل على البلد اذا قالها اقمط	Other
زهر عمري لقيته فيه	Other
أعجبتني هذه الـ #keek URL !dCfaeab والله من الغشامه	Other
السواق الظاهر يمشي شايل السيارة على ظهره وانا ميتتتتتتتتته برررررد URL	Other
شايل بقلبي عليك لكن .. جداً أبيك	Other
USER ياهوه ياواثق خخخخخخخخ خلاص اجل بنخليه يغطي	Other
ودي لو مره اقدر أطيل النظر .	Other
USER جب لي وحده	Other
انا عععطلت وشو؟ ع ط ل ت اااه واخخخيرااا \=D/	Hijazi
يضيع الكلام بالمواقف الحلوه والله يضيع!'	Hijazi
والله عاد وجودك ك عدمك	Other
ㅤ ㅤ ㅤ أعترف لك ! إنكسرت وما أكابر . كنت صابر لين ، مات الصبر فيني . إنت ما كنت بـ حياتي ' غير عابر ! علّق آمالي ورحل ، بـ أجمل سنيني ..	Other
اسري للرياضيات اححسن لك.	Other
هي واضحه من الحين اصلا URL …	Other
ابها مب الطايف	Other
حمدالله بكاهم الموسم الماضي.... وارعبهم ومازال الخوف منه حتى هذا اليوم .. كل ماترونه منهم هو ردة فعل طبيعيه الي سواه فيهم مو شيء بسيط ... كسر ارقامهم الي جمعوها بسنين بموسم واحد.. كانو فرحين بالصداره وفارق ال 9 نقاط وحطم احلامهم قدرو مشاعرهم ولاتلومونهم #حمدالله URL	Other
توني شفت واحد بالبيك لابس اوراوا	Other
#ريال_مدريد_بايرن_ميونخ كل ما ضاقت عليك وانحشرت اتاك الفرج من الحكم وسجلت انفراديه سليمه تحسب تسلل!! وفوق ذلك كرت احمر وعساك تفوز	Other
يع ذا مافتح مقاطعه الا تحوم كبدي URL …	Other
يارب حقيقي ويموت موتة كلاب الحقير #بشار_الاسد_يتعرض_لجلطه_دماغيه	Hijazi
USER اللهم امين والله يجزاك خير يا بوفهد انت صديق ووووفي وسعود يستاهل الله يرحمه ويغفرله	Other
يالا لوعه قلبي.. درجتي في الانقليزي تبكي	Hijazi
يبارك فيك يا مونديالي	Other
حتي بالوقفه يقلدك. .... وشكله ناوي علي النادي	Other
كيف تحسبون الموزونه ياخذول ٤٠٪ من التحصيلي والا ٣٠٪	Other
USER كل الروابط غلط	Other
انا م اتابعها الحمدلله ولا شيء بيستويلي اظن منها	Hijazi
USER سيذا بس من غير سبب..يابعد حي القصيد	Other
ياويلي تنوووكل ربي يحفظها. URL …	Other
ظروف معنداني بتجبرني حبيبي انساك ..	Other
جامع لي كل حنية هالعالم ويسألني: تحبيني؟	Other
الحمممد لله عددددددت على خيرررر ، ذا الدفاااااع يرفع الضغططططططط	Other
طيب وس فيك تصور من جنب ؟	Other
مهبل ، ملاحيس ، مساطيل ، محششين ، متخلفين أوصاف ننعت بها أفراد مجتمعنا ولاندري أنها اشارات سلبية خطيرة لها أشد الأثر على البعض .	Other
ال فتييلللللل ياقلبي	Hijazi
ياخي ازعجتو اهلنا خلاص درينا	Hijazi
وانتي طيبه حبيبتي	Other
جيبو لي شاحن ايفون و ابو كشاف و بلاك وتوصيله لا تنسون	Other
لها اسبوع تدور مشاكل انحشه يا شباب	Hijazi
شكراً للأشخاص اللي مايعجبوننا ولانعجبهمّ، يارب مايتغير رأينا في بعض حبايبي.	Other
اي صايد النصع ابا الفلات	Other
عندي صباح انا با امريكا	Other
USER USER بسئلك شلون احضر محاضرات مباشره وكيف اعرف الوقت واي يوم	Other
ذي سالفه ولا قصيده على بحر ابو رميحان ؟	Other
ما أزعل من الناس الي مايردون بسرعه لاني انا مثلهم تكلمني اليوم ارد عليك بكره .	Other
صارت لي الحين وأحس بصيح ماحب URL …	Other
ماني بحاجه شخص يسمع كلامي انا بحاجه شخص يفهم وش اقول	Other
الصدق لو يجرح ترا دايم جميل .. قسوة وضوح ولا غموض يضيعك..	Other
قلبي والله انتي الجمال كلو احبك	Hijazi
حتى وهو منكرش الا انه للحين متكبر!	Other
احبككككككككككك ي اجمل ماحصلي في ذَا اليوم	Other
رسلت لكم على الخاص رقم بطاقة احوالي ،، وتيتي تيتي مثل مارحتي جيتي	Hijazi
USER طالع كنك القمر مايطلع الا بالشهر مرا وينك فيه لا في مكتبك موجود في الكليه ولا عاد تنشاف في الكليه	Other
ليلٍ طويل..واحبابه سروا بدري.	Other
#الهلال_الاتفاق انشهد قالها جيسوس : قوميز عقوبه للـخصوم URL	Other
أخيرًا ! كفاية أخبار تسد النفس URL	Other
شعاني وأنا قلبي من اللي دهاه يتوق كـما توق حر نابي الضلع يزمي لـه	Other
احد لاحظ ارتفاع في فاتورة الجوال هالشهر؟؟؟ الاتصالات السعوديه!!	Other
أنا أدري إنك وصلت و هزّك الطاري عليّ , جيت وهم م علموني مير أشوف الدار مَمطوره .	Other
يخوي عساف القرني يصدها	Other
USER USER اجيبه يعني اجيبه	Other
USER إناإ آكيد 91 وتحت ما بتعداها	Other
لو جمعت قلوب من حَبك معاي انا اكثر قَلب حَبك بلاحُدود.	Other
والله اظاهر لابه خير في دنيا ولاخر مسحبين جوالين	Other
USER كرس يخلي الخصوم متناقضة غصب	Other
انا عديمة صبر بس انتظرتك كثير!	Other
هو يقدر على الكل الا بنزيما الشوط الاول يدافع مع مايوركا	Other
التمرة غلط يا عمااااااد	Other
#بيت _ اردده _ دائما @ USER بالدنيا وانا مامعي شي ،،، وبروح منها ما معي شي منها ،،،	Other
نصيحة السويلم وسامي ارجل منكم أمس لا حس ولا خبر لكم طلع جمهور ناديكم هو من يدافع عنه أما أنت وامثالك مجرد خيخة..	Other
ماعاد ابا احد،ابا اكون لوحدي وبس	Hijazi
اشخل اكسبلور الانستقرام	Other
الا كتبتي آيه..	Other
USER وانتي من أهله	Other
سوسو .. انا اكتشفت .. انك زود عن انك حمار احمق مثل قردغانك ... السعوديه والامارات والسيسي حلفاء امريكا .. وهي من طالبت بايقاف سلطانك عن عنجهيته حتى رضخ غصبن عليه .. وعلى الي خلفوه .. وقريبا راح ترضخ . انت وعزمي .. وستحاكمون. على جرائمكم .. URL	Other
من يوم كان لاعب وقبل العشرينات وهذي ثقافته وهذي اخلاقه وهذا اتزانه ، رحم الله من عقبوه	Other
جازفوا ترا الحياة ماتستحق كل ذا الحرص..	Other
عادي يمكن تابعوه وتعلموا وهو محب للخير ودورته مجانيه بعض الاقوال تطلع تسلل	Other
تخسون ي طلاحب	Other
أغار لا شفتك لغيري تمون دخيلك حكيك الحلو لغيري لاتقوله..	Hijazi
اضعف قدام الذكريات	Other
مقدر وضعك الليله منت مركز ماتدري من فريقك الضعيف ولا من رعب العالمي وبرحمة وبقول لك شكراً	Other
USER هههههههههههه والله شوف هو مب انا بس مب بعيده تصير لي عادي	Other
USER صبحك الله بالخير يبو محمد وكل عام وانت بألف خير اذا تكرمت بغيتك تضيفني عندك لأني أبغاك بموضوع كان ماعليك كلافه وآسف على ازعاجك	Other
حبيبي حبيبي حبيبي حبيبي حبيبي حبيبي	Other
١٠٠٠٠٠٠٠٠ مبروك يا معالي المستشار تركي ربنا معاك و يوفقك دايما ان شاء الله	Other
رهييبه .. الفلم يخليك تفكر كثييير	Other
يهني معادني محتال اسوق واللا ودي بشوفتكم	Other
عارفة حظك ؟ برافو	Hijazi
يمكن م عرفت كيف أسعدك لكن والله آحبك كثير.	Other
حظ دفاع البرشا في هالحمار	Other
يستاهل القناص محبة الملايين 20 #ياسر_القحطاني_6_مليون_متابع URL	Other
‏ ‏ ‏ لو يسوون كذا عندنا كان محد تخرج للحين URL … ههههههههههههههههههههههههههههه	Hijazi
يمكن هي اللي دافعه المهر	Other
والله يا شينها	Other
ي قلبب سويم URL …	Other
الا ماتقدرين تهونين اختاري فئة بسرعة	Other
انشهد .. فوق فوق تحت تحت يمين يسار يمين يسار اكس دائره .. والقمممم يلاا	Other
مستوى الهموم الي ابي اوصلها	Other
USER وش ها الخدمه	Other
"\" أنا مَحظوظه فِيكَ، آه يامُبهر حبيبتكّ \"."	Hijazi
ماله داعي تقهرني الحين	Other
ينولش كل م بالش يارب	Other
هات فولو مع تم اردها بثواني	Other
تويتر بدون هذي USER مثل البيبي بدون خدمه #ريسبكت	Other
ويلمنّي حكيك,هو للحروف ايدين؟.	Hijazi
ابدا ما تخلي حقك و لو ما كسبتي شئ غير انك تزيدي ثقتك في نفسك لكانت اكبر فايده	Other
أشين شيء بالحياة ' مستعده للنومه ومعطيته وضعية توم وجيري إذا نامو :'( *يشهونك بالنوم* تجي أختك الكبيره تقول لاتسكرين بابك بجي اتسبح بحمامك	Other
‏‎ USER ‏ عادي اصلا الكلاب هنا فريندلي	Other
راموس ينزل الصوره يقول بعد 3 أسابيع عمل الشاق، حان الوقت لاسترخاء يومين قبالة. العد التنازلي على! هلا مدريد..!! URL	Other
الله يديم علي هالمزاج الرايق	Other
حتى الدخان ما اعرف طعمه تعرفين ندوش عندنا كل شيء مايصلح للبنت	Other
ليش تحولني للموظف الآخر ابغى معاملتي عندك و في دايرتك	Hijazi
يقول النبي -صلى الله عليه وسلم : ( من اقتنى كلباً إلا كلب صيد ، أو ماشية ، أو زرع ، فإنه ينقص من أجره كل يوم قيراطان ) .. غير أن الكلب اذا ولغ في الاناء وجب عليه غسل الاناء ٧ مرات احداهن بالتراب لنجاسته وقذارته .. وهالزمن نلقى من يبكي على الكلب ابن الكلب	Hijazi
قد ايش ودي اتطمن بس لا .	Other
لا تجي بعضك ويبقى منك باقي ،لاتجي نصك قسى ونصك شعور يا تجي كلك على قدر اشتياقي او كذا خلك على اخر ظهور.	Hijazi
قلت وينه راح قد عند الحلالٍ لماجيت الا وقبلي جو خالي صاحبي لا علم له..	Other
قوووووول ثاني مييييييسسسسسي	Other
طيب لو بغيت احدث ios 10 اقدر ؟	Other
USER مافي الا دجاج	Hijazi
اعوذ ب الله باقي الطموح على ذا	Other
الريال لا ممكن مفاجأه من توتنهام.	Other
سلااامات افرحي الدنيا ما تستاهل	Other
الام : قوممي ! البنت : Zzz الام : قومممي !! البنت : Zzz الام : ترا بنروحح السوق ؟ البنت : URL ☻=)) التشبيه يجلط	Other
اي انا مجربتها	Other
عوضوا خسارتنا بكرة وخذوا حقنا	Other
"هذا الأسبوع برعاية ؛ - من زمان عنك ، كيف حالك ؟ - اختباري الخميس \" وأظن الجملة هذي أدقّ ما يوصف حالي \""	Hijazi
يافاهيه هي نزلته 2:00 وانا شفته 2:01 فهمتي؟	Other
الله اللي يعيضكم والله يرحمهم ويجعل مثواهم الجنه ان شاء الله	Other
USER الميدان يا حميدان .. وراح انتظر تبريكاتك لنا بعد الجولة الثالثة ..	Hijazi
شُوق وشّقى وقلّة لقى بالله قوليّ وش بقى؟	Other
بدل م تعاقبونه وظفوه على سد الثغرات استفيدو منه.	Hijazi
عجيييب والله، عشم ابليس بالجنه	Hijazi
صدعت من سنابات القرقيعان خلاص يبا	Other
و يمرّ العُمر في قلبي ولا أتعداك تظن أشخاص هالدنيا بـ تاخذني ؟	Other
سوي متابعه لي	Other
": قولوا امين عسى قلوبكم دايم مستريحة لا حزن بها ولا هم ولا ضيقة #فرح_غيرك_ب_كلمه\""	Other
خاف شكله مسويها هههههههههههههههههههههههههههههههههههههههههههههههههههههههههههههههههههههههههههههه URL	Other
يعني هذه حياتي مو فتره وتعدّي؟ URL	Other
آه ياحلللللووووك تكفين !!!	Other
ليه يـ ساعة لقانا ماتجين ؟ دامنا فالحب قلبين خشّرا.	Other
ياليتني من عرب بقعاء .	Other
أُمنية اللحظة : يارب كُل رجل طويّل لسان وقليل ذوق وإحترام وعديّم الإحساس بمشاعر غيّرة كذا فجأة يختفي من الوجود *يريح ويرتاح .	Other
للامانه ازعل اذا انتظرت شخص ولا يكلمني وهو عارف اني منتظره	Hijazi
USER ياهلا بالغالي تسلم الله يطول عمرك يابعدي	Other
جزاك الله خير يابو عامر والله يرحم شيبانك وجعلك تبطي حي وغني ياكحيلان	Other
ياليت فيه آيه تحلل الكذبة البيضا كان بيروح ثلاث ارباع تأنيب الضمير اللي يجيني	Hijazi
احسن شي بالحياة النقصه (تنقذك احيانا)	Other
اللهم امين انه يرزقك بالاخيره ويرزقنا بالباقي واحذلك بيت شعر على حسابي بالحوش	Other
يعني بسرعه اخلصي	Hijazi
وين ما اطقها عوجى URL	Other
قلبي اللي حاضر	Hijazi
#الاردن_سوريا انا شفت منتخبات فيها عاهات .. بس مثل سوريا ماشفت ..مافيهم الا السومه وخربين والباقي كرة القدم بريئه منهم.	Other
الحمدلله الف الف مبروك كل اللعيبه اليوم رجال بالملعب #السعودية_العراق #المنتخب_السعودي #بعزيمه_الرجال_خطوه_للمونديال	Other
إن لم يعجبك كلامي فشبوة في حاجة لمن يحررها ..	Other
يخيسوا خليهم يزوجه ولدهم الله عاد وهالولد فلان على غفله اخاف الصرح مين فلان وادفع عشرين الف وانا مفلسه	Hijazi
فديت راسك يالغالي	Hijazi
كييفو اقال مدربه بعد التعادل مع ميلان .. و #ميلان جدد الثقة باليغري أخذها من اليغري ولا بينات :)	Hijazi
لا حول ولا قوة الا بالله مثقل دمك	Other
USER هذا الكلام الزين ياحبي لقليبك. عز الله أنك وجه مشرف للكره السعوديه	Other
"يهمّني أكون ذكرى حلوة عندك يهمني أكون العمر اللي مرّك ولا ضرّك يكفي كذا وحبّ اللي تحبّ . .\""	Other
ابوي يقول لو انا عميد جامعة القصيم الغيت الخروج مع ولي الامر	Other
#البنات_خربوا_تويتر حتى ببجي ماسلمت	Other
كود 1113 موديل قطعتين جوده وخامه الخامه قطيفه فرنساوى جوده ممتازه التطريز صرمه افضل انواع الخيوط ببنطلون خامه قطيفه وتطريز صرما المقاسات L/xl/xxl/xxxl تلبس من 60 الى 100 كيلو محيط 54/58/62/66 السعر 180 ريال W012_ماى_تارقت# URL	Other
مشعل فيدنا انتم السابقون	Other
تـامـر عـلـىٰ قـلـبي وأقـول يـفداك يـامن ملكت الروح والأمر محسوم قـلـبي معاك يمشي بنفس خطاك وسط الحنايا طيفك اليوم مرسوم	Other
نسيت أقول لكم إني رجعت للفيفا و جبت الفيل الايفواري دروغبا عقبال لامبارد و بالاك و ايسيان و يكتملون ليجند البلوز URL	Other
بتصيرين كيوتتتتتتتت اكثرر	Other
جيزان حلوه بمناظرها وطيبة اهلها	Other
شنو رايك وصلت لحد صرت عايش بشخصيتك	Hijazi
عشان اسمك فاطمه تقولين الكلام هذا بس لو اسمك سانيوريتا كان قلتي بمووووت شدخل ☻	Other
تمثل كيت بريييييال ذا اول حلقه	Other
أحلا شئ تسويه للبنت الي تصور نفسها وتمد بوزها هههههههههههههههههه URL ”	Other
اوك انا معك انه خطأ بس ماله داعي الشووووووووووو URL …	Other
ياصبي عسره والله عندنا افضل منه ولا نبيه فتاح والمأشر والمقهوى وغريب فيه بالدرجه الاوله افضل وارخص ولو مميز بيخذه الفريق المدلل	Other
ممكن مب نفس الكلام يأثر، لكن محاولتهم بزرع هذه الفكرة تخليك تتأثرين :)	Other
⠀ ' علموها كان تدري في غلاها الكبير إني علي حبها ثابت ولاحولي ميــول ⠀	Other
كان يجمع طاقه .. الحين اكثر واحد متحمس	Other
نبذه عن فهاوتي اليوم الله يستر من الاختبار URL	Hijazi
صحّة روحك الله يسعدك وتستاهل ياشاعرنا الغالي	Other
"ابوي لو اطيح قدامه بالغلط قال من الدشره والسهر والسربته الى آخر الليل \"̮"	Hijazi
بالنسبه للي يكتبون المحادثات القديمه توجعنا وتآثر فينا ءءءاا ي حبكم ل التفليم ي ناقصين الحنان احذف المحادثه وفك امنا منك مالنا ذنب تبثرنا.	Other
USER USER اكييد ..لييه عندك شك ؟؟	Hijazi
كـثيـرون يـسألـونـَي ؛ مـّن أنـَا فـأجـيبـهم بـكل ثـقـة : أنـَا مـثل الـفـرصـة مـّرة فـّي حـياتِگ ..[ مـّا تـتكـرر مـرتـين ]	Other
حبيبتي الله يعافيك يا عيوني انتي	Other
مين الي حتبكي زي الأطفال لما تصحى الساعة ٧ ؟	Hijazi
USER USER فهمت لا موب عطرية	Other
أبشركـ .. بنتظر عمري كله قلبي واقف محله مثل ظلكـ وراكـ ~	Other
وصلنا ربع النهائي العام الماضي تبريراتك انك ممثل الوطن الوحيد هاذي العب ع غيرنا وي الله ي ابو اثنين نقطه وصفر بطولات ذا الموسم	Other
و انا بطبل معك من بعيد URL	Other
USER الله يسهلها معنا طيب السكان كيفه ذكرت ولا لا	Other
مابي منك سواك شفني طيرٍ من رحلت واقصى حدودي .. سماك !	Other
#الاااهللللي_ضمممككك_الدددورييي يهواك .. من عافنا عفناه ولو كان غالي ر zcA	Other
احيانا الغياب يكون وايد احسن من اللقا حتئ لو كان يالم او يجرح	Other
ياعالميين تاق نشط همتكم تكفون نبغاه ترند تكفون ياعالميين #اهازيج_النصر_مشاري_المهلكي	Other
صح بدنك الابداع ذوقكك	Other
USER الباث موجودين فيه ناس +18 اغلبهم كذا	Other
ماني مصدق لو اني شفت يعيوني اكذب اعيوني الثنتين من شانك وقول هذي من ؟الشيطان وظنوني الين قلت الغدر في عظمة السانك	Other
#الاهلي_الوحدة اشتقنا ي الاهلي اشتقنا رغم انك مزعلنا ......	Other
USER كيمياء ما اعتقد لكن اذا ودك تجربين ترسلين السيره الذاتيه اضيفيني عشان اعطيك ايميل التوظيف	Other
حبيبييييي اف احبك	Other
استوت على محايل عسير ماشاء الله URL	Other
انت تدري ان اوراوى تأهل هذا اذا عدى السد ولا انت تقصد مثل 170	Other
USER سوري ي الحبيب قريتها ع عجله	Hijazi
الفلوس لان اذا اخترتها بتجي راحة البال والزواج وبكذا ثلاثه في واحد	Other
#اسهل_وصفه_للسعاده تعيش جوّك وتسحب على كل مايفقع المرارة	Other
نسير!!!!! وتت هههههههههههههههههههههههههههههههههههههههههههههههههههههه	Hijazi
الله يلعن الم القالون اقوم من نومتي من وجعه.	Other
ماما وستو كدا ف ما استبعد يكونو وصلو لمامتك	Hijazi
#أكثر_سؤال_مر_عليك_بالمدرسة الاستاذه:انتي ماخذه مفتاح غرفة المصادر انا:لا الاستاذه:فيه وحده مره تشبهلك وانا بتخرج ولابعدشفت الي تشبه لي	Other
خلف كل فتاة شقردية كاشخه بحسابها وسط تيفوا التراب .. شقردي كيوت URL	Other
مشكورين جداً جداً وتسسسستاهل انت ياحبيب القلووووووب	Other
ما اركز كثير فالتويتر. بس انا معك ١٠ سنوات ماسمعتك تقول اسمه. ماعندك مجال ناوي اخرب العلاقات	Other
يالله بعلمً يجي من صوب محبوبي	Other
جوجو تاكل الهتل	Other
ماتهمني كوره الطائره لو يفوزون الطحالب على العالمي الهلال نقول مبروووووك اهم شيء مباراتنا الليله مع الترجي بإذن الله نتجاوزها بالتوفيق للازرق الملكي العالمي	Hijazi
ملاييييين ملاييين تحبك يبو متعب #الجوهرة #أبداع #روعة	Other
لاا ياحيي بتطير معلوماتي	Other
نصي ايي ونصي لا	Other
تسلم يا سيدي .. بعض ما عندكم	Hijazi
بحملها واشوف لأن ماعمر في لعبة عجبتني صدق	Other
دخلت معاه نقاش وبلكني لاني عرفت انه مو اهلاوي اتمنى الجهور الاهلاوي يكون عنده وعي ويبلك المندسين	Other
يا حبيبي اكتب زين الحين وخل السب عنك	Other
لازم اخذ كورسات عنده اتعلم	Hijazi
مستحيل ميسي يمسك كورة ويتخذ قرار خاطئ عشان كذا مع كل كورة يمسكها فيه خطورة حتى لو بنص الملعب	Other
الأهل هُم الأشخاص الي فعلاً يحبونِك بدون أي مُقابل .	Other
بلغوا عنها مكافحة الجرائم الالكترونية عشان ماعاد تسرق ثاني مره	Other
ضحايا برونو رد مشرف على الجحفله بس نقول العالميه صعبه قويه	Other
USER والفتح بعد بس مدري من الحكم	Other
عرفتي من فين ؟	Hijazi
محبة الناس نعمة مافي شي يضاهيها .	Other
إلى قدم السنه الي فاتت وما انقبل قبول مبدئي وهو خريج 1438 يقدر يقدم مره ثانيه ؟	Other
اتمنى راعي الاغنام يدفي دكة URL …	Hijazi
يبقى نقفله علشان الجو برد ونفير العنوان كمان مع السلامه والقلب داعيلهم	Other
كم أحبك تكفيك حتى تعرفين شكثر انتِ حبيبتي ؟	Hijazi
"\" USER : سيّد الورد من مثلك! قصيدٍ قيل في غيرك حرام إنه ماهو لأجلك♡\""	Other
مرت سياره مشغلين اغنيتي المفضله.	Other
انتي سري اللي بطلت اعلنه كل شيء بالسر عُمره طويل.	Other
انت الهنا ، اللي دعيت ربي يديمه.	Other
لو بنزيما او لاكازيت موجودين افضل من جيرو	Other
USER USER أنا من يوم شفت مانشيني كل مباراة يغير الدقيقة 89 وأنا غاسلن يدي	Other
ال سعود دايسين راسك	Other
تعـال : خذ / قلبي تعب : حيل مني وعــطني مثل : قلــبك بليد / واناني قلبـي : علي غيبــه عيونك جرحنــي وقلبك عشق في غيبتي شخص ثاني	Hijazi
ماعندك دوام قد اجازتي بعد يومين	Other
اول مرة اشوف واحد يتعوذ من نفسه.	Other
USER عليكم؛آنا آبوي إيش رآيكم ف بنتي؟ - قص لسانها شوي . URL	Hijazi
USER تلحفي ونومي بس	Other
اتمنى والتعبير يكون من ضمنها لان اتوقع هذي من اكثر المشكلات نواجهها ويمكن حسيت بالفرق اثناء دراستك في امريكا والفرق بين الامريكان والسعوديين	Other
الله يحفظها ويخليها لكم	Hijazi
USER عادية جدا جدا جدا توقعت احسن من كذا .. ناهيك الحضور راح يكون قليل	Other
اللي ما يملي عينه وجودي ما يفرق معاه بُعدي .	Other
USER 90,000 بس ؟ لا شوي يختي زودي بعد	Other
بنندم على كل لحظه ماذكرنا فيها ربنا .	Other
خلاصص لاأحد يجيب اخبار النادي التدريبات مغلقه تكفون USER USER	Hijazi
عادي ارجع اتفرج عليه المره الثالثه ؟ URL …	Other
أجليدهم كلهم الضحكة في معظم المقاطع الهندية	Hijazi
لا ، الجهاز لوحدة بيسوي كذا ، مع العلم غيرنا ازرار الصامت	Hijazi
USER يقولون الطماطم صار غالي ودك نفتح لنا مزرعه ونصدر للسعوديه ؛$	Other
والله ما اشوف فيها شي	Hijazi
يارب عام مليان نشاط وسعاده وفرح	Other
طقم شانيل شنطه شانيل شوز شانيل المقاسات من 36 الي 41 السعر 290ريال W012_ماى_تارقت# URL	Other
مدري إلى اليوم توله على مضناك والا انتهى حبي؟!!!!!!!!	Other
حساب مهكر قراند ؟	Other
اليوم عودة الجولة الثانية وأول مباريات الموسم في ملعب الإمارت بحول الله مستوى ونتيجة طيبه بيرنلي ماهو الفريق اللي تخاف منه وفريقنا قوي بعد #AFC	Other
شفت نوور عيني	Other
ههههههههههههههههههههههههههههههههههههههههههههه شفيك علي	Other
لفت نظري الساعة .. جميلة بس وش نوعها ؟	Hijazi
فكونا من هالمصطلحات ترا اللاعبين ماهم ناقصين ضغوطات زياده	Other
مبروك ياالامير الله يصلحه ويجعله من حفظة كتاب الله ويرزقك بره	Other
USER ماريو نبغى نقاط الدعم والمقاومة والاتجاه العام لزوج الدولار ين مع الشكر ...	Hijazi
ي رب تخفضيات ف ايكيا	Hijazi
الحمدالله درجاتي ارتفعت يارب اعدي ذا المستوي علي خير مرره مبسوطه	Other
USER يبو عالي تشلسي مو ملتزم دفاعياً،مو وقته يجرب المدرب تكتيك معين في نهائي مهم زي هذا! لو لعب بطريقة دوري الابطال كان افضل.	Hijazi
سيكس. سيكس اجنبي	Other
صرت زي الكخه الحين هه	Other
نفس الطريق الي تمره امره بس م نلتقي ...	Other
للاسف بعد اليورو اتضح نصبكم واحتيالكم بطاقتي فيها شهرين وعشان اشتراك لازم اجدد سنة ...؟ ايش النصب والاحتيال هذا	Hijazi
الموقع يعطيني ومو قادر أسجل Server Error in '/' Application. The wait operation timed out	Other
اصلا تعليمش منخفض وغلط انتي اني ادخل في حوار معش	Other
بغى يشيل المرايه مسرع	Other
ما احسني فاقد حبيب احسني فاقد بلد...	Other
شريت فيفا من الاستور على انه ينزل اليوم طلع باقي يوم و ١٦ ساعه متحمس كنت بمسك خط	Other
— هيييييييه أكثر واحد دعم الآرميز انا يوم يجون بتس #curiouscat URL …	Other
#وجه_تحيه_لشخص_في_تبوك فديت تبوك و الي سكن تبوك يصعب عليه العيش في غيرها	Other
كلنا عندنا ذاك اليوم اللي نتمنى يرجع مره ثانيه .	Other
الله يشفيه ويقومه بالسلامة	Other
هذا اللي خلاه يعلق	Hijazi
ما رحمت الا اطفال النصر يلعبون عليهم انهم وصلو كأس العالم وهم ما شافو وشلون ترشح وانفضحتوا بعدها نصيح اذا لك ولد او اخو خله يشجع الزعيم عشان الضغط URL	Other
Titanfall 2: Become One Official Launch Trailer من زمان عن هاذي النوعية من التريلرات جميل جدا URL	Other
يافهد ياليت تعطينا حساب او رقم نتواصل فانا من ضمن المشمولين	Other
وحبك مثل المدينه بعين اهل الحجاز روح عاد فسر حب اهل الحجاز للمدينه	Other
والله اللي يشوف اللعب يحس انها مباريات حواري او صالات على هالمهارات. بعيد جداً عن الواقعيه هالسناريوهات ما تصير في كرة القدم الا نادر جداً	Other
حبيبتي انتي سوم	Other
انا صار لي شهر استخدمها لي كم يوم ملاحظه انا اثار الحبوب خفت بشكل كبير واقول شكلو عشان من زمان مااحط مكياج طلعت الصابونه جداً خورافيه مع اني ريحتها وبالصدفه اخذتها كمان	Hijazi
ودي اني في البوليفارد الحين	Other
اي طلبو مقابله بكره الاثنين	Other
يععع والله لاوجه ولا جسم ذنوب ع الفاضي هي وياه وفضيحه عند العربان بعد	Other
USER مستانسه؟ بتاكلين تبن باول ثانوي	Other
اخرص خالص ما تتكلمش..يا شيخ انت حتى احتياط فرق الدرجه الثالثه كثير عليك..!! URL	Hijazi
فيكم شده نحوسه هو وناديه ؟ USER URL …	Other
لقيت بسواد عيُونها موطني ياملاذ هالقُلب ياريحة هّلي.	Other
تعلميني فيهم اعرفهم ملاعين .	Other
": اذان الفجر يجيب لك خمسين فتوة تُبيح الإمساك قبل \"حي على الفلاح\" اذان المغرب يفطر على كحة المؤذن"	Other
اولا الي كتب الهاشتاق من جنبه مايعرف يكتب وثانيا اشكر كل الي كتبوا اسمي بالهاشتاق وان شاء الله اقابلكم #شخصيه_تاريخيه_ترغب_بلقايها	Other
USER سلمت يابو نايف وكل عام وانت بخير	Other
يبنات هدو اللعب	Hijazi
USER تجربة موفقه من الشكل بس جوعتي المسلمين	Hijazi
أبغي سيارة مثلها	Hijazi
طقوس ليلة الاختبار استلذ بكل لقمة وشَربة >> طيب الكتاب ها اي كتاب؟ اي اختبار؟ هوا اليوم ايش؟ يوم التبلد العالمي URL	Hijazi
ماعليك منهم بس لا تمددها .. يلا انت وياها كل واحد على فراشه بسرعه ههههههههههههههههههههههههههههههههههههههههههههههههههههه #تمديد_الاجازه_للثلاثاء URL	Other
السلام عليكم ورحمة الله وبركاته انا مروقه في عز الظهر . مع السلامه	Other
كل تبن يالملحوس	Other
أنا من كثرمااعصابي انشدت راسي عورني ضغطي نرفع حسبيالله بروح انام اسلكلي.	Other
"وين انت يالي تلتفت كل ما ضقت ما عاد لك حتى مع الناس طاري\""	Other
الله عالالحاد فزت بالدخان الثاني	Other
يخرب بيت القوه . . BY: USER URL …	Hijazi
خلاص هاردلك ارسنال	Hijazi
USER ، االله يحقق مُرادك ، آمين وياك ..	Other
طمنوني كيف مستوى اوراوا ، وش اللي ينافسون على الهبوط في دوريهم	Hijazi
شوفي لي وحده	Hijazi
بالضبط الله يحفظها ويسعدها ويتمملها على خير	Other
ياحبيبنا يابلديات هههههههه	Other
USER كيف الطريقه - اول كانت شغاله تمام بس الان لا	Other
وصادفتك واثاريني انا من وقتها مُلهَم!	Other
اففف الحماس لبكره مليوننن	Other
USER متعودين الملكيين على تصرفات الملوك ..	Other
يارب يتحرك ضميري واذاكر تعبت	Other
خلوا سعيد يتهنى بسعيده	Other
كالعاده نامي ترا كثر السهر مايجيبه.	Other
ما ناقصني غيرك بهالجو	Other
لك دعائي لك عيوني و العمر	Other
كنت اتعمد النظره عشان احظى بنظراتك'	Other
#Rabeh2019 ياساتر ع التوووتر من فين ابدا URL	Hijazi
يشيخه الله يجعني فدا كم احبك الله يخليك لي يارب	Other
هذي يدين البرد ولاّ يدينك !	Other
"المشكلة إنك ما تقدر تطلب من الناس إنهم يسألوا عنك.\""	Other
اخواني يوم نزلت اول حلقه منgot URL	Other
مشتاق اكل مثل اول.	Other
رايحين بإذن خارج السعودية قريباً	Hijazi
خل احساسك مكانه	Other
USER هلا ابوريما ،، ياخوك وش ذا البرد اللي رجع فجأه	Other
ليته من قلة النوم، انا اكثر واحد ينام	Other
قبل سنوات اليوم عطهم جوال بس	Other
الله يتمم لك ياحلوه	Other
USER وين تجيني التغريده ؟؟؟	Other
مدري صحيح او لا URL	Other
اي والله مانبي يجينا الدور URL …	Other
سوسو البقره كيف السهره URL …	Other
ظروف الوقت تجبرني على الراحة و شاريها.	Other
أجرنا أجرك عزيزي مشكور وما قصرت	Other
USER طيب مااشوفكم تذكرون منطقة لاليلي في السكن رغم انها منطقة فنادقها جيده	Other
بإذن الله الايام الجايه على المنوال	Other
USER وانا ولد خالتي	Other
- متى العناد يصير حلو ؟ لما تعاندين شخص تحبينه وينقهر.	Hijazi
بارك الله فيكم...سامي الجابر راح يرجع يلعب لكم ؟	Hijazi
URL مُش مجرد مسرحية أطفال، الكلمات دروووس	Hijazi
أكره حيرة إلـ وين أروح أو مين أكلم.	Other
وش دوامك عاد لقافه	Other
مااااشششاءااللله اذا ماكان عندي ازق بنت عمه.	Other
برضو كل زق	Other
بعمركم ما تمنّيتوا يكون حق التملّك للبشر حق مفتوح؟ اكثر قانون اتمنى يُتاح لي.	Hijazi
بعض القصيد تقول عطرٍ على جرح خفو ترا فـ أرواحنا . . . ما كفاها !	Other
غيابك يشبه وصالك ... وصلك طول الغيبة	Hijazi
لكل فريق قدر فريقك وهمي كله وعشان كذا خصصنا له وهمي للوهميين	Other
#اي_نوع_من_الهدايا_تفضل وش فيها لو كانت كفرات للسياره	Other
عادي بحط صورتي	Other
URL … رابط للي يبي يسأل للفيزيا ( اقروا الموجود قبل تحطون سؤالكم )	Other
من سمحلك تحط اسطورتنا رياكشن يا دب	Other
تسلم يالامير ربي يسعدك	Other
ياطيب راسك وساسك يابو عبدالله	Other
طبعا هذا بافتراض انه فيه دولة اسمها إسرائيل لان اي واحد معترف بوجودها ينطبق عليه نفس الكلام	Other
هذا واحد من العيال ببلاستيشن	Other
يارجال ماعندك ماعند جدتي USER	Other
قمة القهر لما يجيك طفل ضيف ويطيح فيك ضرب وتشويت وانت تطالع أهله وتبتسم وتقول : يحليله ، الله يخليه لكم وانت ودك تمسكه وتنتفه تنتيف =))	Hijazi
أنتي ما تحسين وراك درجات اخر سنة شفيك كذا قومي ذاكري تحركي شوفي لك حل أنا : URL	Other
ذيلها ياصل عرقوبها بالطول	Other
USER انا مادري والله اشوف وجهها ولا غيرره	Other
والله عيب يابنت حرب	Other
ما اتعرفت ع احد عشان اسحب	Other
‏ ‏ ☇ ‏ ‏ ‏ الجو يدفعني لـكل شي / نآسيھ ! من روعتھ آمشي و آسوُلف مسبّھ ولوُ : مرني وآحد آنا ( ما ادآنيھ ) يمكن مع ھآلجو آنسى و آحبه	Other
سعيد المولد ، اتوقع رؤية المملكه ٢٠٣٠ بتفشل بسبب تواجده	Other
ماهكذا تورد الابل . جا يكحلها عماها.	Other
من أجمل إلى أجمل ماشاء الله الله يطول بعمرك	Other
ايش قصته؟ خنتابعه معاك	Other
شوف اذا بتدخل تخصص حلو وتقدر تشد حيلك وتجيب معدل حلو ادخل جامعه اما اذا منت واثق من امكانياتك لا تدخل بتضيع ٤ سنوات على الفاضي	Other
دنيا انا حلاوة بنص ماتجيني URL	Hijazi
ضمني حتى اقول اني اكتفييت واسحب ايديني وعيد اللي حصل أنت نهر عذب منه ما ارتويت ضم قلبي وعوضه فقر الوصل !	Other
نيفيز اذا ما سجل اعطاك حل للتسجيل	Other
مين يفهمك غيري؟	Hijazi
والله انا على نفس موضوعي اي معلومه تفيدني عن الجنسية والقبول لعل الله يفرجها وتعطيني طاقة	Other
يارب يعدي الثلاثاء على خيييير	Other
حبيبي الأهبل الغَبي .. يحسّ إنه عن إحساسي بعيد وهو ما بقى مكان بداخلي ما زاره .	Other
انتصر عىيد الكوره في النهايه URL	Other
اخي الغالي محمد تجي هذه الحاله لنا كلنا والمطر ماحد يقدر يصبر عنه خذ اجازه وعود علينا	Other
#كله_من_السهلاوي الراتب خلص كله من السهلاوي	Other
ايش يصبرنا للموسم الثاني	Other
مسوي مقلب في اخوياه في ههههههههههههه URL	Other
فيه اذا استوردناك فتحنا السوق وكنت اول حمار مستورد	Other
ههههههههههههههههههههههه الدنيا بسييطه عند الاطفال URL …	Other
لا نامت الناس قمنا بالهوى نسري ناس تبوح المواجع ، وناس تخفيها	Other
ليش ماقلت النصر؟	Other
كإبرس منحاش من الدورية ويمشي ع الجنط واحترقت السيارة ونط منها URL …	Hijazi
مهما تقولون في زينه وفي شينه محدٍ يشوفه مثل ما أشوفه بعيني	Other
USER الحسيني قال جروس اعطاهم راحة يومين لكن السومة والفهمي حيتمرنو	Hijazi
يالله وين المترجمين	Other
مااخس منك الا هو طبلوا لبعض ايها المكروهون	Hijazi
يمه قلبي شايل عليها كرههه لو يقولوا اذبحيها بذبحها	Other
الدفاع بيموتني اذا كان ذا مستواهم في اسيا	Other
تريد ابجي صدق حلمان	Other
والله ياهي رفعة ضغط الليله #ببجي صاير بوت	Other
ماحبيت السنات وماادخله كثير	Other
يسعدك ربي يامطلق	Other
نعم الحمد لله قبل نص ساعه.	Other
الف شكر لك ذوق والشكر موصول للادارة ربي يسلمكم تسلمين ذوق	Other
USER والمفروض على ادارة نادي #الرائد قبل يعملون على اين يعسكر الفريق يجهزون الاعبين نفسياً قبل كل شيء الاعبين لا يحضرون اكيد فيه شيء	Other
ماقويت الصبر حبه تمكن فيه..،	Other
يابختك بأجرهم واهتمامك فيهم	Hijazi
لا تكفين بنموت يعني .	Other
#فلم_اعجبك امووووووووووت ع الأفلام الهنديه يربي ادامان استغفر الله .	Other
برت؛ احب تفكيرها وكلامها	Other
الحكم !!!!!!! لمسة يد واضحةة يارجل !	Other
شخصين احمد ومحمد قال احمد لمحمد عطني ريال يصير معي ضعف الي عندك قال محمد عطني انت ريال يصير معي قد الي عندك فكم مع كل منهما؟؟؟؟	Other
هذا اللي مايجمع غياباته اول الترم	Other
هو فيه مثلك ياللي الحسن ظلك ،ليه العطر ؟! وانتي انفاسك دخون..وليه الكحل؟!وانتي ماغيرك عُيون ..وليه تفكيرك يكون انك تكوني دايم اجمل؟!انتي اجمل من جمالك من دلالك من خيالك..	Other
USER USER بشوف عشان لا اقلدهم بعدين	Other
ويجون الرجال يسمون الصفين الأولى كلها أزرق .. URL	Hijazi
وهو صادق عاجبتني	Other
ان شاء الله ان الخبر صدز امنيتي خيسي اشوفه برا ويبقون على اسينسو	Other
التخزينه نااار مسويه شغل العن من الكبتي	Other
وكمان كم واحد منهم توظف بغير تخصصه بس عشان يحصله رزق	Other
"\" USER : الملكة اليزابيث ختمت كل الالوان URL \"حلوه الصورة"	Other
الضحكه عليه أكثر من ماهي على الطواقي	Other
صفحتي مالها روح من دونتس URL	Hijazi
برده مصممين تضحكونا لكن معليش يا زملكاوية أحبايب قلبى URL	Other
حسب خبرتي ان 2 بصك 1 باللي معه في يده	Other
أحب روتيني ليوم الجمعة خصوصاً وقت ما اسمع صوت تنبيهات جوال اللي بالبيت كلهم بوصول بي سي يوم الجمعة شعور لطيف والله.	Other
اذا م جاء بأخذ بطانيتي وبروح له	Hijazi
الله يعينك ي جار	Other
مولود كل مايبغو يبعدوه عن امه يبكي كميه لطافه ف المقطع #شي_تحبه_بحياتك URL	Hijazi
باقي لي أربع حلقات وأخلص مسلسلي وأحس إني حزين جداً	Other
ياحبيبي من صوتك واضح بردان ؟ USER .	Other
زيدني منك يـاعساني ما اكتفيك!”	Other
هُو تَحدّي يآ حَظّ وإلاّ ؛ لَعانَہْ ..؟!!	Hijazi
شالسالفه #بيان_4_لحركة_21_ابريل	Hijazi
ههههههههههههههههههههههههههههههههههههه ياخي بارك لنا طيب	Other
يكسّرون فيك ألف خاطر ويقولون لك إنت متغيّرعلينا*.	Other
معليش شكلي جيت من بعيد وانبرشت هههههههههههههه	Other
اها تلحس بعضك	Other
ياليت تخلوها اسبوع بس	Other
حتى لو شغل الدبل الله يحفظك فرامل اللكزس عالي التأمين والتثبيت لأن فرامله كهرباء ودام القير P خلاص انسى يتحرك	Other
وش جنسيتك ؟ أنا : طبعا والنعم بالكل	Hijazi
USER خلك حول الموقع او اكتب لوحة اكيد راعيه بيمر الموقع	Other
و انتي طيبة وبخير وسعادة و سنة جديدة سعيدة عليكي يااجمل فنانة	Other
موقفه حجوزات لفتره شوي طويله لو رجعت بعطيكم خبر انتظروني	Other
قال صبه قال احقنه .	Other
كنت نفسك بعدين مدري شصار	Other
هههههههههههههههههههههههههههههههههههههههههههههههه قالولك منى	Other
أكتب بقوقل محلات بيع معدات المطاعم واسأل عن آلة الايسكريم الصيني نفس مواصفات هذي وبعدها سِمْ ... وسننهج النهج النبوي: سمحاً إذا باع سمحاً إذا اشترى ..	Other
الجحلط اللي راحوا يمثلونا في روسيا ؟	Other
بعض الاوامي عسى ربي يهاديها #حياتك34	Hijazi
مين الكلب اللي نام وراحت عليه المحاضره ؟	Other
USER طانكيو طانكيو مره كتير	Other
ودي مررررة اشوف فقراوي يتكلم في ناديه ويترك الهلال للهلال الهلال فريق كبييير وجمهوره عظيم وصدارة بس	Other
امين ي عيوني	Other
ايه،انتي الوحيده اللي تفهميني احبك URL	Other
ما شاء الله تبارك الله. الصليخه الي ترسم عليه قد التلفزون في الحجم	Other
الله يستر اتحمست ابغا اعرف ايش	Hijazi
#حكم_من_وحي_الطعام ياداخل بين البصله وقشرتها ماينوبك إلا ريحتها	Other
هذا ماسيحدث .. قريبا .. والي مافيه خير لوالده لاتنتظر من ولده خير والبر والعقوق سلف ودين .	Other
بكره عملية أختي دعواتكم لها	Hijazi
مو اول مره كل سنه حرام تضيع مقاعد ولا يستفاد	Other
فولو ولايك وينرد	Other
اهم شي ونصيحة قانونية اذا سويت تسوية مديونية خذ منهم شهادة مخالصة	Hijazi
فن التعامل مع الازمات ههههههههههههههههههههههههههههههههههههههههههه ! URL …	Other
#تغريده_تهديها_لمن_تحب أنا وقلبْي في هوا عيونك نتُوه.	Other
متتت ياخي متت ههههههههههههههههههههههههههههههههههههههههههههههههههههههههههههههههههههههههههههههههههههههههههههههههههههههههههههههههههههههههههههههههههههههههههههههه	Other
هالأسبوع الي مو راضي يخلص !!	Other
انتم تتكلمون عن سفراء روسيا نسيتو عيالنا المبتعثين طلبه هناك لاتزعلونهم لايسون في عيالنا شي #اطردوا_سفراء_الروس	Other
»تًخِيِلُِآتُ .. تخيل انك راكب هالقطار وتشوف هالمنظر!! URL …	Other
USER مصطفى مداوم اليوم مايدري أن بوه تعليق للدراسة !!! URL	Other
الف مببروك ياحب والله يوفقك ويحققلك مبتغاك	Hijazi
الله يسعدك يالغالي مرورك من ذهب	Other
الله يخليك تعالي،اذا عجبك ابدا فمسيرة مساج سطوحي،هههههههههههههههههههههههههههههههههه،!!!.	Hijazi
عههععهههههههعههههههههه الاانااااعرفكم من يوم ولدتك امك	Hijazi
USER كلامه مو كلام واحد واثق ويتهرب من بعض الاسئله	Other
الله يذكر قلبه الطيّب بخير .. عساه من فرحه ، لفرحه ، لفرحه !	Other
USER وين روابط أهداف مباريات أبطال أسيا لهذا اليوم	Other
يعني بطل اشاعات	Other
شوف ديرتك وبعدين اتكلم	Other
USER اليوم اقرى تغريداتك وشفت هالصوره ربي يبارك فيها ويحفظها ولا يحرمكم من بعض	Other
يمدي يصيدونه لان اكيد بيفتشون كل شيء حتى مهملات المرحاض	Other
اوك في إنتظاركم	Other
شعنده الوكت وياي شنهو اليريده.”” ساعه انا بيـد الموت ساعه انا بيـده’”	Other
في الدوري الارجنتيني الفريق الخصم ما له حق يحضر مباراة خارج ارضه، يعني بوكا جونيور اذا لعب ضد ريفر بليت في ملعب ريفر بليت ما يحضر لهم جمهور ولا واحد بالمئة و مع ذلك ما منع الحضور الجماهيري بوكا جونيور الفوز خارج ارضه! المباراة الجاية مباراة مدرب و لاعب يطبق و هدف في الشوط ١	Other
قبل تستغفل شخص جرب تحط نفسك مكانه ترا والله شينه الحركه	Other
احتاج انام ثلاث أيام بلياليها	Hijazi
يَ مـساء الخير ي العود المسقّـا .. ي لطيف الحـس يالـروح الزكيــه .. انـت لامن جيت في صدري .. تنـقّـا كـل ضلـعٍ في ضلوعي لک عطيه	Other
كنك اياي، ميد من	Other
عندي ساعة من سواتش انقطعت رحت لمحلهم طلبو مني 90 ريال ، حصلتها بالموقع ب 6 ريال والشحن مجاني URL	Hijazi
فكره.. وع كل نفر ١٠٠ ريال حركه مشروع ناجح	Other
البليهي لو اني حبيبته صار فيني انفصام	Other
أبي انهار بس مافي وقت وكل بسبت امل الي ماحدث المقارنات	Hijazi
مادري وراه ودي العن وجهك	Other
اي حيوان يسوي مثلهم هذا مصيره	Other
"امر بفترة \"عايز حد يدلعو\""	Other
وش سويت ي أهلي فينآ ؟	Hijazi
يابختكم عندكم بنت أخت مثلي #اليوم_العالمي_للخاله	Other
اتوقع محد عندو هوس تجميع الدفاتر والاقلام قددي	Hijazi
ألف لا باس عليك يا عبدالله وقدامك العافية إن شاء الله	Other
أجل ليش تقولي زعلانه	Other
ما لقيت لي شغلة أتهرب بها غير تكسير الزجاج ونحته .	Other
الله علييييييييييك، بكل ما بك آسري همسك وصوتك يا غلاي وضحكتك تدري وش اجمل شيّ يسعد خاطري؟ شوقك، وكلماتك، ولهفة نظرتك.	Other
انا توني واصل للتنانين الثلاثة تبي تجلدهم معي	Other
الحارس الوحيد اللي مادخل عليه ولاهدف URL	Other
شكرا كثير والله	Other
تجمع سوائل حوالين القلب وهيا حالة طارئة تحتاج تدخل سريع لأنها تمنع القلب انها تضخ الدم	Hijazi
على حسب نيتها بالرقص إذا تستعرض خلاص توقف URL …	Hijazi
قمت من النوم ولقيت كل البيت طالع!!	Other
لاحظت اذا حبيت اغنيه كل ناس تحبها سبعاااه صدق	Other
هذا عملة الي يعاند النظام والحكومة ويشوف انه اعلى منهم ويتحداهم يستاهل مايجيه لايهم العرق الجنس العمر	Other
صدفت توقعين بس	Other
عبدالمجيد يغني مشاعر مش حروف *	Other
الاولاد كبرت يابومحمد URL	Other
أبكي ومالي صاحبه تضم دمعتي اتذكر احبابي وأصد كني ناسيّه	Other
ودي اصدق بس قويه هذه ليس من اطباع جيش حرر بلاده وحرر نصف بلادك وانت منبطح	Other
هو اتمنى لو يكون صحيح لان الاعب كانتي ماله مكان بالتشكيله وتوظيفه بالتشكيله مختلف عن امكانياته	Other
USER ههههههه لاتسوي لي فلو يابو ضروس ولاتقول عني عنصري	Other
مهما تعددت صداقاتي محد وصل للمستوى المطلوب	Hijazi
طقطقة بالجوال : | #4 | فكتور | iVictor | وطبينا في تفتيش .. يلا ابي... URL	Hijazi
شتبون روحو ذاكرو	Other
“الانسداح قبل #النوم وانت ماسك الجوال يعادل السفر حول العالم =((”	Other
ايوه غير بالحر	Hijazi
حبيبتي انتي علينا وعليك..خلينا نشوفك	Other
ماعرفتني والله ،اهم شي تشبيه ساره وريم ، ساره الثانيه حبيبة قلبي URL	Other
لحد يكذب عليك ويقول اسوء شعور انك تخسر حبيب اصعب شعور صح انك تصحى من النوم وتلاقي شاحنك 1٪ وتفتحه ويطفي عليك ههههههههههههههههه	Other
اه طلعة بر مع الحبايب والذبيحة بالصندوق	Other
وليفربول حقق الابطال بسببك بعد ..ياهو نافخ نفسه URL …	Other
يارب هذا الأسبوع يخلص بسرررعه ويعدّي على خير	Other
ياعمري انتي انتي تستاهلي اكتر من كدا والله مهما عملنا قليل عليكي جدا بحبك الله يسعدك حبيبتي URL …	Hijazi